食堂今日的菜单？	qa_dining
食堂今天早上有面条吗？	qa_dining
食堂下周菜单里有炒饭吗？	qa_dining
今天食堂的水果是什么	qa_dining
今天中午有啥菜推荐的	qa_dining
早餐今天是什么蛋糕	qa_dining
面条的价格是多少？	qa_dining
面条多少钱？	qa_dining
这个菜多少钱？	qa_dining
这个菜什么价格？	qa_dining
面条什么价格？	qa_dining
今天早上的面多少钱？	qa_dining
下午的面多少钱？	qa_dining
今天的午饭多少钱？	qa_dining
今天的晚饭多少钱？	qa_dining
今天的荤菜多少钱？	qa_dining
面条是不是5快？	qa_dining
今天有没有面条？	qa_dining
今天中午吃什么?	qa_dining
今天中午有啥菜推荐的	qa_dining
今天有没有面条？	qa_dining
食堂今日的菜单？	qa_dining
饭馆今儿个的菜单？	qa_dining
食堂今日的菜系？	qa_dining
酒家今日的菜单？	qa_dining
酒馆今天的菜单？	qa_dining
馆子今日的菜单？	qa_dining
食堂今的菜单？	qa_dining
食堂今儿的菜单？	qa_dining
食堂今日的菜谱？	qa_dining
食堂今天的菜单？	qa_dining
食堂今天早上有面条吗？	qa_dining
食堂今天早上有面吗？	qa_dining
食堂今朝早晨有面条吗？	qa_dining
食堂今天晁有面条吗？	qa_dining
食堂今天朝有面条吗？	qa_dining
食堂今日早上有面条吗？	qa_dining
食堂今早晨有面条吗？	qa_dining
食堂今儿早有面条吗？	qa_dining
饭铺今天早上有面条吗？	qa_dining
餐饮店今天早上有面条吗？	qa_dining
食堂下周菜单里有炒饭吗？	qa_dining
食堂下周菜系里有炒饭吗？	qa_dining
食堂下半年菜单里有炒饭吗？	qa_dining
饭铺下周菜单里有炒饭吗？	qa_dining
食堂下周一菜单里有炒饭吗？	qa_dining
饭庄下周菜单里有炒饭吗？	qa_dining
食堂下周食谱里有炒饭吗？	qa_dining
餐馆下周菜单里有炒饭吗？	qa_dining
饭庄下周菜系里有炒饭吗？	qa_dining
食堂下星期菜单里有炒饭吗？	qa_dining
今天食堂的水果是什么	qa_dining
今天食堂的果品是哎	qa_dining
今儿个食堂的水果是什么	qa_dining
今天食堂的水果是呦	qa_dining
今天食堂的果品是什么	qa_dining
今天食堂的水果是咦	qa_dining
今日食堂的水果是哟	qa_dining
今酒家的水果是嗬哟	qa_dining
今日食堂的水果是什么	qa_dining
今天馆子的水果是什么	qa_dining
今天中午有啥菜推荐的	qa_dining
今天中午有啥菜援引的	qa_dining
今天中午有啥菜荐举的	qa_dining
今天中午有啥菜引荐的	qa_dining
今天晌午有啥菜推介的	qa_dining
今日午有啥菜推荐的	qa_dining
今天日中有啥菜推荐的	qa_dining
今天正午有啥菜推荐的	qa_dining
今天午有啥菜推荐的	qa_dining
今中午有啥菜引荐的	qa_dining
早餐今天是什么蛋糕	qa_dining
早餐今天是什么蜂糕	qa_dining
早饭今天是什么蛋糕	qa_dining
早餐今天是什么发糕	qa_dining
早餐今天是什么糕	qa_dining
早餐今天是嗬蛋糕	qa_dining
早餐今儿是什么蛋糕	qa_dining
早餐今朝是什么蛋糕	qa_dining
早餐今天是什么丝糕	qa_dining
早餐今天是什么年糕	qa_dining
面条的价格是多少？	qa_dining
面条的价格是些许？	qa_dining
面条的价格是微微？	qa_dining
面条的价格是不怎么？	qa_dining
面条的标价是微微？	qa_dining
面条的价格是有些？	qa_dining
面条的价格是稍稍？	qa_dining
面条的价位是多少？	qa_dining
面条的价格是稍事？	qa_dining
面条的价格是稍微？	qa_dining
面条多少钱？	qa_dining
面多少钱？	qa_dining
这个菜多少钱？	qa_dining
以此菜多少钱？	qa_dining
是菜多少钱？	qa_dining
本条菜多少钱？	qa_dining
此菜多少钱？	qa_dining
斯菜多少钱？	qa_dining
者菜多少钱？	qa_dining
夫菜多少钱？	qa_dining
这个菜什么价格？	qa_dining
这个菜什么标价？	qa_dining
这个菜什么价？	qa_dining
者菜什么价格？	qa_dining
这个菜啊价格？	qa_dining
这个菜嘻价格？	qa_dining
斯菜什么价格？	qa_dining
这菜什么价格？	qa_dining
这个菜啊价位？	qa_dining
本条菜嘿价格？	qa_dining
面条什么价格？	qa_dining
面条嘻价格？	qa_dining
面条什么价位？	qa_dining
面条什么价？	qa_dining
面条什么标价？	qa_dining
面条嘿价格？	qa_dining
面条哎哟价位？	qa_dining
面条啊价位？	qa_dining
面条什么价钱？	qa_dining
面好家伙价格？	qa_dining
今天早上的面多少钱？	qa_dining
今天天光的面多少钱？	qa_dining
今日早上的面多少钱？	qa_dining
今天早的面多少钱？	qa_dining
今天晁的面多少钱？	qa_dining
今天早间的面多少钱？	qa_dining
今儿早上的面多少钱？	qa_dining
今天早晨的面多少钱？	qa_dining
今天早起的面多少钱？	qa_dining
今儿个早上的面多少钱？	qa_dining
下午的面多少钱？	qa_dining
午后的面多少钱？	qa_dining
下半晌的面多少钱？	qa_dining
后晌的面多少钱？	qa_dining
后半天的面多少钱？	qa_dining
下半天的面多少钱？	qa_dining
今天的午饭多少钱？	qa_dining
今朝的午饭多少钱？	qa_dining
今天的午宴多少钱？	qa_dining
今天的午餐多少钱？	qa_dining
今天的中饭多少钱？	qa_dining
今的午餐多少钱？	qa_dining
今的午饭多少钱？	qa_dining
今儿的午饭多少钱？	qa_dining
今日的中饭多少钱？	qa_dining
今儿个的中饭多少钱？	qa_dining
今天的晚饭多少钱？	qa_dining
今儿的晚饭多少钱？	qa_dining
今儿的晚餐多少钱？	qa_dining
今日的晚饭多少钱？	qa_dining
今天的夜饭多少钱？	qa_dining
今的晚饭多少钱？	qa_dining
今儿个的晚饭多少钱？	qa_dining
今朝的晚饭多少钱？	qa_dining
今的夜饭多少钱？	qa_dining
今朝的夜饭多少钱？	qa_dining
今天的荤菜多少钱？	qa_dining
今的荤腥多少钱？	qa_dining
今天的肴多少钱？	qa_dining
今儿个的荤菜多少钱？	qa_dining
今朝的荤菜多少钱？	qa_dining
今天的大鱼多少钱？	qa_dining
今的荤菜多少钱？	qa_dining
今日的油腻多少钱？	qa_dining
今天的油腻多少钱？	qa_dining
今儿个的肴多少钱？	qa_dining
面条是不是5快？	qa_dining
面是不是5快？	qa_dining
面条是否5快？	qa_dining
面是否5快？	qa_dining
今天有没有面条？	qa_dining
今儿有没有面？	qa_dining
今朝有没有面？	qa_dining
今日有没有面条？	qa_dining
今朝有没有面条？	qa_dining
今天有没有面？	qa_dining
今儿有没有面条？	qa_dining
今儿个有没有面条？	qa_dining
今有没有面条？	qa_dining
今天中午吃什么?	qa_dining
今日中午吃什么?	qa_dining
今儿个中午吃什么?	qa_dining
今天午间吃什么?	qa_dining
今中午吃什么?	qa_dining
今天午吃什么?	qa_dining
今天午间吃哟?	qa_dining
今天中午吃好家伙?	qa_dining
今朝中午吃什么?	qa_dining
今日中午吃哎呀?	qa_dining
今天中午有啥菜推荐的	qa_dining
今日日中有啥菜推荐的	qa_dining
今天日中有啥菜推荐的	qa_dining
今天晌午有啥菜推荐的	qa_dining
今朝中午有啥菜援引的	qa_dining
今天正午有啥菜推荐的	qa_dining
今天午有啥菜推荐的	qa_dining
今儿个中午有啥菜推荐的	qa_dining
今天中午有啥菜荐举的	qa_dining
今午间有啥菜荐的	qa_dining
今天有没有面条？	qa_dining
今天有没有面？	qa_dining
今儿个有没有面条？	qa_dining
今朝有没有面条？	qa_dining
今有没有面条？	qa_dining
今日有没有面条？	qa_dining
今儿有没有面条？	qa_dining
今日有没有面？	qa_dining
今儿有没有面？	qa_dining
食堂今日的菜单？	qa_dining
食堂今日菜单	qa_dining
食堂今日的菜单	qa_dining
食堂今天早上有面条吗？	qa_dining
食堂今天早上有面条吗	qa_dining
食堂今天早上面条	qa_dining
食堂今天早上面条吗	qa_dining
食堂今天早上有面条	qa_dining
食堂下周菜单里有炒饭吗？	qa_dining
食堂下周菜单里有炒饭	qa_dining
食堂下周菜单有炒饭吗	qa_dining
食堂下周菜单里有炒饭吗	qa_dining
食堂下周菜单里炒饭	qa_dining
食堂下周菜单里炒饭吗	qa_dining
食堂下周菜单有炒饭	qa_dining
食堂下周菜单炒饭吗	qa_dining
食堂下周菜单炒饭	qa_dining
今天食堂的水果是什么	qa_dining
今天食堂水果是	qa_dining
今天食堂水果	qa_dining
今天食堂的水果是	qa_dining
今天食堂的水果	qa_dining
今天中午有啥菜推荐的	qa_dining
今天中午有啥菜推荐	qa_dining
今天中午有菜推荐	qa_dining
今天中午有啥推荐	qa_dining
今天中午啥菜推荐	qa_dining
今天中午有推荐	qa_dining
今天中午啥推荐	qa_dining
今天中午菜推荐	qa_dining
今天中午推荐	qa_dining
早餐今天是什么蛋糕	qa_dining
早餐今天什么	qa_dining
早餐今天是什么	qa_dining
面条的价格是多少？	qa_dining
面条的价格是多少	qa_dining
面条价格多少	qa_dining
面条的价格多少	qa_dining
面条价格是多少	qa_dining
面条多少钱？	qa_dining
这个菜多少钱？	qa_dining
这个菜多少钱	qa_dining
这个多少钱	qa_dining
这个菜什么价格？	qa_dining
这个菜什么价格	qa_dining
这个什么价格	qa_dining
面条什么价格？	qa_dining
面条什么价格	qa_dining
今天早上的面多少钱？	qa_dining
今天早上的多少钱	qa_dining
今天早上的面多少钱	qa_dining
今天早上面多少钱	qa_dining
今天早上多少钱	qa_dining
下午的面多少钱？	qa_dining
下午的面多少钱	qa_dining
下午面多少钱	qa_dining
下午多少钱	qa_dining
下午的多少钱	qa_dining
今天的午饭多少钱？	qa_dining
今天午饭多少钱	qa_dining
今天的午饭多少钱	qa_dining
今天的晚饭多少钱？	qa_dining
今天晚饭多少钱	qa_dining
今天的晚饭多少钱	qa_dining
今天的荤菜多少钱？	qa_dining
今天的荤菜多少钱	qa_dining
今天荤菜多少钱	qa_dining
面条是不是5快？	qa_dining
面条是不是5快	qa_dining
今天有没有面条？	qa_dining
今天有没有面条	qa_dining
今天中午吃什么?	qa_dining
今天中午吃什么	qa_dining
今天中午什么	qa_dining
今天中午有啥菜推荐的	qa_dining
今天中午有啥推荐	qa_dining
今天中午有啥菜推荐	qa_dining
今天中午有推荐	qa_dining
今天中午啥菜推荐	qa_dining
今天中午有菜推荐	qa_dining
今天中午菜推荐	qa_dining
今天中午推荐	qa_dining
今天中午啥推荐	qa_dining
今天有没有面条？	qa_dining
今天有没有面条	qa_dining
食堂今日的菜单？	qa_dining
食堂今天早上有面条吗？	qa_dining
食堂今天早上有元宝大头虾吗？	qa_dining
食堂今天早上有冬瓜吗？	qa_dining
食堂今天早上有汤米粉吗？	qa_dining
食堂今天早上有白粥吗？	qa_dining
食堂今天早上有八宝辣酱面吗？	qa_dining
食堂今天早上有油三角塞肉吗？	qa_dining
食堂今天早上有茭白丝炒蛋吗？	qa_dining
食堂今天早上有紫薯饼吗？	qa_dining
食堂今天早上有冬瓜虾皮汤吗？	qa_dining
食堂今天早上有司康吗？	qa_dining
食堂今天早上有小饼干吗？	qa_dining
食堂今天早上有饼干吗？	qa_dining
食堂今天早上有酸菜鱼片吗？	qa_dining
食堂今天早上有韭菜炒蛋吗？	qa_dining
食堂今天早上有花卷吗？	qa_dining
食堂今天早上有黄芽菜吗？	qa_dining
食堂今天早上有酱鸭腿吗？	qa_dining
食堂今天早上有红糖发糕吗？	qa_dining
食堂今天早上有杭白菜吗？	qa_dining
食堂今天早上有黄芽菜木耳吗？	qa_dining
食堂今天早上有鱼香茄子吗？	qa_dining
食堂今天早上有干煎板鱼吗？	qa_dining
食堂今天早上有夜开花炒面筋吗？	qa_dining
食堂今天早上有糍毛团吗？	qa_dining
食堂今天早上有鸡鸭血粉丝汤吗？	qa_dining
食堂今天早上有肉松蛋糕吗？	qa_dining
食堂今天早上有莴笋炒肉丝吗？	qa_dining
食堂今天早上有干锅有机花菜吗？	qa_dining
食堂今天早上有泡椒肥羊卷吗？	qa_dining
食堂今天早上有牛奶吗？	qa_dining
食堂今天早上有水果塔吗？	qa_dining
食堂今天早上有绿豆汤吗？	qa_dining
食堂今天早上有谷物牛奶麦片吗？	qa_dining
食堂今天早上有藤椒仔鸡吗？	qa_dining
食堂今天早上有巧克力麦芬吗？	qa_dining
食堂今天早上有茶叶蛋吗？	qa_dining
食堂今天早上有荷塘小炒皇吗？	qa_dining
食堂今天早上有米苋吗？	qa_dining
食堂今天早上有芋艿吗？	qa_dining
食堂今天早上有番茄蛋汤吗？	qa_dining
食堂今天早上有芸豆培根面吗？	qa_dining
食堂今天早上有糟溜鱼片吗？	qa_dining
食堂今天早上有刀豆土豆条吗？	qa_dining
食堂今天早上有西葫芦吗？	qa_dining
食堂今天早上有麻辣梭子蟹吗？	qa_dining
食堂今天早上有椒盐薄饼吗？	qa_dining
食堂今天早上有咸肉骨头黄吗？	qa_dining
食堂今天早上有老黄瓜烧开洋吗？	qa_dining
食堂今天早上有炒藕丝吗？	qa_dining
食堂下周菜单里有炒饭吗？	qa_dining
今天食堂的水果是什么	qa_dining
今天中午有啥菜推荐的	qa_dining
早餐今天是什么蛋糕	qa_dining
早餐今天是什么海带丝	qa_dining
早餐今天是什么五香黄花鱼	qa_dining
早餐今天是什么棉花糖奶冻	qa_dining
早餐今天是什么香菠咕咾肉	qa_dining
早餐今天是什么辣仔鸡丁面	qa_dining
早餐今天是什么椒盐排条	qa_dining
早餐今天是什么抹茶蛋糕	qa_dining
早餐今天是什么酸辣藕丝面	qa_dining
早餐今天是什么油三角塞肉	qa_dining
早餐今天是什么烤布丁	qa_dining
早餐今天是什么荷塘小炒皇	qa_dining
早餐今天是什么白煮蛋	qa_dining
早餐今天是什么荷叶夹	qa_dining
早餐今天是什么炒藕丝	qa_dining
早餐今天是什么清蒸鲳鱼	qa_dining
早餐今天是什么家常豆腐	qa_dining
早餐今天是什么老干妈炒粉丝	qa_dining
早餐今天是什么酱鸭腿	qa_dining
早餐今天是什么咖喱鸡块	qa_dining
早餐今天是什么葱烤大排	qa_dining
早餐今天是什么番茄炒蛋	qa_dining
早餐今天是什么黄芽菜	qa_dining
早餐今天是什么馒头	qa_dining
早餐今天是什么藤椒仔鸡	qa_dining
早餐今天是什么肉包刀切	qa_dining
早餐今天是什么巧克力麦芬	qa_dining
早餐今天是什么大肉拼南瓜	qa_dining
早餐今天是什么八宝辣酱面	qa_dining
早餐今天是什么茭白丝炒蛋	qa_dining
早餐今天是什么香辣翅根	qa_dining
早餐今天是什么老黄瓜烧开洋	qa_dining
早餐今天是什么油条	qa_dining
早餐今天是什么尖椒毛豆炒肉丝	qa_dining
早餐今天是什么冬瓜	qa_dining
早餐今天是什么水果塔	qa_dining
早餐今天是什么慕斯塔	qa_dining
早餐今天是什么芸豆炒肉片	qa_dining
早餐今天是什么葱油薄饼	qa_dining
早餐今天是什么小馄饨	qa_dining
早餐今天是什么豆沙包刀切	qa_dining
早餐今天是什么山芋	qa_dining
早餐今天是什么绿豆汤	qa_dining
早餐今天是什么烧麦	qa_dining
早餐今天是什么小饼干	qa_dining
早餐今天是什么芋艿	qa_dining
早餐今天是什么小番茄	qa_dining
早餐今天是什么清蛋糕	qa_dining
早餐今天是什么地三鲜	qa_dining
早餐今天是什么米苋	qa_dining
面条的价格是多少？	qa_dining
南瓜的价格是多少？	qa_dining
水煮牛肉片的价格是多少？	qa_dining
洋葱炒鸡柳的价格是多少？	qa_dining
炒素面的价格是多少？	qa_dining
炒素的价格是多少？	qa_dining
白粥的价格是多少？	qa_dining
珍珠肉圆的价格是多少？	qa_dining
酸奶的价格是多少？	qa_dining
家常豆腐的价格是多少？	qa_dining
麻辣香锅虾的价格是多少？	qa_dining
干锅有机花菜的价格是多少？	qa_dining
卷心菜的价格是多少？	qa_dining
香蕉的价格是多少？	qa_dining
杭白菜的价格是多少？	qa_dining
鱼香茄子的价格是多少？	qa_dining
荷叶夹的价格是多少？	qa_dining
司康的价格是多少？	qa_dining
鸡鸭血烩豆腐的价格是多少？	qa_dining
巧克力麦芬的价格是多少？	qa_dining
番茄蛋汤的价格是多少？	qa_dining
鸡鸭血粉丝汤的价格是多少？	qa_dining
糍毛团的价格是多少？	qa_dining
黄豆咸肉骨的价格是多少？	qa_dining
蛋糕的价格是多少？	qa_dining
酱鸭腿的价格是多少？	qa_dining
馒头的价格是多少？	qa_dining
谷物牛奶麦片的价格是多少？	qa_dining
卤水仔鹅的价格是多少？	qa_dining
炒肉的价格是多少？	qa_dining
馄饨的价格是多少？	qa_dining
酸辣藕丝面的价格是多少？	qa_dining
可可蛋糕的价格是多少？	qa_dining
小饼干的价格是多少？	qa_dining
土豆丝的价格是多少？	qa_dining
葱油鸡腿的价格是多少？	qa_dining
酱爆猪肝面的价格是多少？	qa_dining
农家土蛋糕的价格是多少？	qa_dining
芸豆炒培根的价格是多少？	qa_dining
炒藕丝的价格是多少？	qa_dining
油焖茭白肉丝的价格是多少？	qa_dining
油条的价格是多少？	qa_dining
芸豆培根面的价格是多少？	qa_dining
桂花条头糕的价格是多少？	qa_dining
萝卜丝海蜇皮的价格是多少？	qa_dining
肉包刀切的价格是多少？	qa_dining
海带丝的价格是多少？	qa_dining
咖喱鸡块的价格是多少？	qa_dining
水果塔的价格是多少？	qa_dining
烧麦的价格是多少？	qa_dining
面条多少钱？	qa_dining
这个菜多少钱？	qa_dining
这个菜什么价格？	qa_dining
面条什么价格？	qa_dining
香煎板鱼什么价格？	qa_dining
豉椒炒仔鸡什么价格？	qa_dining
红烧土豆什么价格？	qa_dining
椒盐薄饼什么价格？	qa_dining
沙律牛排什么价格？	qa_dining
莴笋炒肉丝什么价格？	qa_dining
白粥什么价格？	qa_dining
慕斯蛋糕什么价格？	qa_dining
香干榨菜肉丝什么价格？	qa_dining
葱烤河鲫鱼什么价格？	qa_dining
香酥仔鸡什么价格？	qa_dining
布朗尼什么价格？	qa_dining
炒素什么价格？	qa_dining
饼干什么价格？	qa_dining
芸豆炒培根什么价格？	qa_dining
黄油蛋糕什么价格？	qa_dining
辣仔鸡丁面什么价格？	qa_dining
佛手瓜木耳鸡片什么价格？	qa_dining
老干妈炒粉丝什么价格？	qa_dining
双色窝窝头什么价格？	qa_dining
芋艿什么价格？	qa_dining
海带丝什么价格？	qa_dining
焖蹄面什么价格？	qa_dining
巧克力麦芬什么价格？	qa_dining
酸辣汤什么价格？	qa_dining
茭白肉丝面什么价格？	qa_dining
桂花条头糕什么价格？	qa_dining
五香黄花鱼什么价格？	qa_dining
黄芽菜什么价格？	qa_dining
水饺什么价格？	qa_dining
四喜烤麸什么价格？	qa_dining
农家小炒肉什么价格？	qa_dining
茭白丝炒蛋什么价格？	qa_dining
干锅千页豆腐什么价格？	qa_dining
番茄蛋汤什么价格？	qa_dining
白煮蛋什么价格？	qa_dining
黄豆芽什么价格？	qa_dining
毛血旺什么价格？	qa_dining
八宝辣酱面什么价格？	qa_dining
卷心菜什么价格？	qa_dining
榨菜肉丝蛋汤什么价格？	qa_dining
卷心菜木耳什么价格？	qa_dining
珍珠肉圆什么价格？	qa_dining
冬瓜什么价格？	qa_dining
上豆烧小白蹄什么价格？	qa_dining
黄芽菜木耳什么价格？	qa_dining
粟米炒鸡粒什么价格？	qa_dining
油条什么价格？	qa_dining
红枣米糕什么价格？	qa_dining
今天早上的面多少钱？	qa_dining
下午的面多少钱？	qa_dining
今天的午饭多少钱？	qa_dining
今天的晚饭多少钱？	qa_dining
今天的荤菜多少钱？	qa_dining
面条是不是5快？	qa_dining
长生果是不是5快？	qa_dining
绿豆汤是不是5快？	qa_dining
酱爆猪肝面是不是5快？	qa_dining
茶叶蛋是不是5快？	qa_dining
窝窝头是不是5快？	qa_dining
水果黄瓜是不是5快？	qa_dining
葱油薄饼是不是5快？	qa_dining
麻辣梭子蟹是不是5快？	qa_dining
青红椒山药肉片是不是5快？	qa_dining
酸辣汤是不是5快？	qa_dining
芋艿是不是5快？	qa_dining
珍珠肉圆是不是5快？	qa_dining
野山椒基围虾是不是5快？	qa_dining
藤椒仔鸡是不是5快？	qa_dining
南瓜饼是不是5快？	qa_dining
锦绣虾仁是不是5快？	qa_dining
油麦菜是不是5快？	qa_dining
鸡鸭血烩豆腐是不是5快？	qa_dining
油三角塞肉是不是5快？	qa_dining
红枣米糕是不是5快？	qa_dining
脆皮鲜奶是不是5快？	qa_dining
馄饨是不是5快？	qa_dining
黄芽菜是不是5快？	qa_dining
元宝大头虾是不是5快？	qa_dining
提拉米苏是不是5快？	qa_dining
卷心菜是不是5快？	qa_dining
抹茶蛋糕是不是5快？	qa_dining
素鸡面是不是5快？	qa_dining
家常豆腐是不是5快？	qa_dining
老黄瓜烧开洋是不是5快？	qa_dining
巧克力熔岩是不是5快？	qa_dining
葱油生瓜是不是5快？	qa_dining
飘香辣仔鸡是不是5快？	qa_dining
香煎板鱼是不是5快？	qa_dining
头汤是不是5快？	qa_dining
棉花糖奶冻是不是5快？	qa_dining
荷塘小炒皇是不是5快？	qa_dining
咸菜肉丝面是不是5快？	qa_dining
清蛋糕是不是5快？	qa_dining
上汤娃娃菜是不是5快？	qa_dining
番茄蛋汤是不是5快？	qa_dining
干煎板鱼是不是5快？	qa_dining
西湖牛肉羹是不是5快？	qa_dining
小番茄是不是5快？	qa_dining
荷叶夹是不是5快？	qa_dining
水煮牛肉片是不是5快？	qa_dining
榨菜肉丝面是不是5快？	qa_dining
汤米粉是不是5快？	qa_dining
豆沙包刀切是不是5快？	qa_dining
今天有没有面条？	qa_dining
今天有没有炒素？	qa_dining
今天有没有谷物牛奶麦片？	qa_dining
今天有没有干煎小黄鱼？	qa_dining
今天有没有元宝大头虾？	qa_dining
今天有没有茭白肉丝面？	qa_dining
今天有没有葱烤大排？	qa_dining
今天有没有豆沙包刀切？	qa_dining
今天有没有酱鸭腿？	qa_dining
今天有没有香茜小素鸡？	qa_dining
今天有没有洋葱香干肉丝？	qa_dining
今天有没有焗吐司？	qa_dining
今天有没有刀豆土豆条？	qa_dining
今天有没有农家小炒肉？	qa_dining
今天有没有布朗尼？	qa_dining
今天有没有慕斯塔？	qa_dining
今天有没有牛奶？	qa_dining
今天有没有红烧肉圆面？	qa_dining
今天有没有四喜烤麸？	qa_dining
今天有没有老干妈炒粉丝？	qa_dining
今天有没有芸豆培根面？	qa_dining
今天有没有青红椒山药肉片？	qa_dining
今天有没有黄豆咸肉骨？	qa_dining
今天有没有咖喱鸡块？	qa_dining
今天有没有葱烤河鲫鱼？	qa_dining
今天有没有豆汤？	qa_dining
今天有没有西葫芦？	qa_dining
今天有没有芋艿？	qa_dining
今天有没有麻辣香锅虾？	qa_dining
今天有没有面？	qa_dining
今天有没有飘香辣仔鸡？	qa_dining
今天有没有农家烧老鹅？	qa_dining
今天有没有卤水仔鹅？	qa_dining
今天有没有巧克力熔岩？	qa_dining
今天有没有莴笋丝炒蛋？	qa_dining
今天有没有香辣牛蛙？	qa_dining
今天有没有素鸡面？	qa_dining
今天有没有荷叶夹？	qa_dining
今天有没有尖椒土豆肉片？	qa_dining
今天有没有粟米炒鸡粒？	qa_dining
今天有没有夜开花炒面筋？	qa_dining
今天有没有茶叶蛋？	qa_dining
今天有没有鸡鸭血烩豆腐？	qa_dining
今天有没有双色窝窝头？	qa_dining
今天有没有卷心菜？	qa_dining
今天有没有宫保鸡丁？	qa_dining
今天有没有夜开花烧面筋？	qa_dining
今天有没有芸豆炒培根？	qa_dining
今天有没有黄芽菜胡萝卜？	qa_dining
今天有没有桔子？	qa_dining
今天中午吃什么?	qa_dining
今天中午有啥菜推荐的	qa_dining
今天有没有面条？	qa_dining
今天有没有绿豆汤？	qa_dining
今天有没有油麦菜？	qa_dining
今天有没有司康？	qa_dining
今天有没有菌菇小炒皇？	qa_dining
今天有没有水果黄瓜？	qa_dining
今天有没有地三鲜？	qa_dining
今天有没有菜包花卷？	qa_dining
今天有没有香干榨菜肉丝？	qa_dining
今天有没有椒盐排条？	qa_dining
今天有没有谷物牛奶麦片？	qa_dining
今天有没有干锅有机花菜？	qa_dining
今天有没有黄豆芽？	qa_dining
今天有没有荷叶夹？	qa_dining
今天有没有藤椒仔鸡？	qa_dining
今天有没有肉包刀切？	qa_dining
今天有没有青菜？	qa_dining
今天有没有酱油炒饭？	qa_dining
今天有没有红烧土豆？	qa_dining
今天有没有桔子？	qa_dining
今天有没有毛豆节？	qa_dining
今天有没有面？	qa_dining
今天有没有水果塔？	qa_dining
今天有没有花卷？	qa_dining
今天有没有豆豉炒鸭脯？	qa_dining
今天有没有葱油南瓜？	qa_dining
今天有没有豆汤？	qa_dining
今天有没有糟毛豆大头虾？	qa_dining
今天有没有黄芽菜？	qa_dining
今天有没有焗吐司？	qa_dining
今天有没有上豆烧小白蹄？	qa_dining
今天有没有焖蹄面？	qa_dining
今天有没有酸菜炒饭？	qa_dining
今天有没有清蒸鲳鱼？	qa_dining
今天有没有豆沙包刀切？	qa_dining
今天有没有椒盐薄饼？	qa_dining
今天有没有水煮牛肉片？	qa_dining
今天有没有八宝辣酱？	qa_dining
今天有没有酱鸭腿？	qa_dining
今天有没有西湖牛肉羹？	qa_dining
今天有没有粉蒸大肉？	qa_dining
今天有没有上汤娃娃菜？	qa_dining
今天有没有农家烧老鹅？	qa_dining
今天有没有芸豆炒培根？	qa_dining
今天有没有鱼头豆腐汤？	qa_dining
今天有没有咸菜绿豆芽？	qa_dining
今天有没有黄油蛋糕？	qa_dining
今天有没有巧克力熔岩？	qa_dining
今天有没有脆皮鲜奶？	qa_dining
今天有没有洋葱炒鸡柳？	qa_dining
今天晚上有班车么	qa_bus
明天早上有班车么	qa_bus
晚上班车几点	qa_bus
早上班车几点	qa_bus
班车在哪里上车  	qa_bus
班车可以到哪里	qa_bus
晚上9点下班还有班车吗 	qa_bus
12号线班车中间停其他地铁站吗？	qa_bus
我15分钟后想坐9号线的班车来得及吗	qa_bus
今晚2号线有班车吗  	qa_bus
2号线班车在哪个门坐  	qa_bus
2号线班车到哪个地铁站	qa_bus
今晚9号线有班车吗  	qa_bus
9号线班车在哪个门坐  	qa_bus
9号线班车到哪个地铁站	qa_bus
今晚12号线有班车吗  	qa_bus
12号线班车在哪个门坐  	qa_bus
12号线班车到哪个地铁站	qa_bus
班车几分钟一班	qa_bus
我坐1号线8点的班车，大概什么时候到公司	qa_bus
下一班班车什么时候开走	qa_bus
几点有班车？	qa_bus
班车几点？	qa_bus
今天晚上有班车么	qa_bus
今日夜幕有班车么	qa_bus
今天晚上有私车么	qa_bus
今儿个晚上有班车么	qa_bus
今儿个夜里有班车么	qa_bus
今儿晚上有班车么	qa_bus
今天夜间有首车么	qa_bus
今天晚上有早班车么	qa_bus
今天夜里有班车么	qa_bus
今朝晚上有班车么	qa_bus
明天早上有班车么	qa_bus
明天晁有慢车么	qa_bus
明天晁有班车么	qa_bus
明天早上有专车么	qa_bus
明天早上有早车么	qa_bus
翌日早上有快车么	qa_bus
明天早上有餐车么	qa_bus
明晨有班车么	qa_bus
次日早上有班车么	qa_bus
明朝早上有班车么	qa_bus
晚上班车几点	qa_bus
夜间班车几点	qa_bus
晚上公车几点	qa_bus
夜班车几点	qa_bus
晚上私家车几点	qa_bus
夜里班车几点	qa_bus
夕班车几点	qa_bus
晚上空车几点	qa_bus
晚上临快几点	qa_bus
夜晚班车几点	qa_bus
早上班车几点	qa_bus
早晨班车几点	qa_bus
晁首车几点	qa_bus
早间专用车几点	qa_bus
早上夜车几点	qa_bus
早上早车几点	qa_bus
晁班车几点	qa_bus
早上慢车几点	qa_bus
早上快车几点	qa_bus
早上私家车几点	qa_bus
班车在哪里上车	qa_bus
班车在哪上车	qa_bus
晚车在哪里上车	qa_bus
首车在哪里上车	qa_bus
班车在哪里上街	qa_bus
空车在哪里进城	qa_bus
班车在何上车	qa_bus
快车在哪里上车	qa_bus
早车在哪里进城	qa_bus
末班车在哪里上车	qa_bus
班车可以到哪里	qa_bus
早班车可以到哪里	qa_bus
班车可以到哪	qa_bus
空车可以到哪里	qa_bus
守车可以到何在	qa_bus
班车得以到哪里	qa_bus
班车可以到何	qa_bus
班车可以到何在	qa_bus
班车足以到岂	qa_bus
快车好到哪里	qa_bus
晚上9点下班还有班车吗	qa_bus
夜幕9点下班还有班车吗	qa_bus
晚上9点下班还有守车吗	qa_bus
晚上9点下班再有班车吗	qa_bus
晚上9点下班还有餐车吗	qa_bus
晚上9点下班还有公车吗	qa_bus
晚上9点放工还有班车吗	qa_bus
晚上9点收工还有班车吗	qa_bus
夜间9点收工还有空车吗	qa_bus
夜间9点下工再有班车吗	qa_bus
12号线班车中间停其他地铁站吗？	qa_bus
12号线班车中间停其他航天站吗？	qa_bus
12号线班车中档停其他边防站吗？	qa_bus
12号线班车当中停其他地铁站吗？	qa_bus
12号线头班车中间停其他地铁站吗？	qa_bus
12号线班车中间停外地铁站吗？	qa_bus
12号线班车中间停另地铁站吗？	qa_bus
12号线班车中间停其他中转站吗？	qa_bus
12号线特快中间停其他地铁站吗？	qa_bus
12号线专车中间停其他地铁站吗？	qa_bus
我15分钟后想坐9号线的班车来得及吗	qa_bus
我15分钟后想坐9号线的临快来得及吗	qa_bus
我15分钟后想坐9号线的餐车来得及吗	qa_bus
我15分钟后想坐9号线的早班车犹为未晚吗	qa_bus
我15毫秒后想坐9号线的班车来得及吗	qa_bus
我15秒钟后想坐9号线的首车来得及吗	qa_bus
我15分钟后想坐9号线的班车亡羊补牢吗	qa_bus
我15分钟后想坐9号线的班车犹为未晚吗	qa_bus
我15分钟后想坐9号线的公车来得及吗	qa_bus
我15一刻钟后想坐9号线的班车来得及吗	qa_bus
今晚2号线有班车吗	qa_bus
今晚2号线有餐车吗	qa_bus
今晚2号线有夜车吗	qa_bus
今夜2号线有班车吗	qa_bus
今晚2号线有特快吗	qa_bus
今晚2号线有公车吗	qa_bus
今夜2号线有特快吗	qa_bus
今晨2号线有班车吗	qa_bus
今夜2号线有守车吗	qa_bus
今晚2号线有快车吗	qa_bus
2号线班车在哪个门坐	qa_bus
2号线快车在谁人门坐	qa_bus
2号线班车在孰门坐	qa_bus
2号线班车在谁门坐	qa_bus
2号线班车在何人门坐	qa_bus
2号线私车在哪个门坐	qa_bus
2号线慢车在哪个门坐	qa_bus
2号线班车在哪位门坐	qa_bus
2号线空车在哪个门坐	qa_bus
2号线专用车在谁人门坐	qa_bus
2号线班车到哪个地铁站	qa_bus
2号线班车到哪个雷达站	qa_bus
2号线班车到谁地铁站	qa_bus
2号线餐车到哪个接待站	qa_bus
2号线班车到谁个地铁站	qa_bus
2号线班车到何许人也地铁站	qa_bus
2号线班车到何人地铁站	qa_bus
2号线特快到哪个航天站	qa_bus
2号线早车到哪个地铁站	qa_bus
2号线首车到哪个地铁站	qa_bus
今晚9号线有班车吗	qa_bus
今晚9号线有头班车吗	qa_bus
今晚9号线有早班车吗	qa_bus
今夜9号线有班车吗	qa_bus
今夜9号线有专车吗	qa_bus
今晨9号线有班车吗	qa_bus
今晚9号线有早车吗	qa_bus
今宵9号线有班车吗	qa_bus
今晚9号线有空车吗	qa_bus
今晚9号线有临快吗	qa_bus
9号线班车在哪个门坐	qa_bus
9号线班车在谁门坐	qa_bus
9号线夜车在谁人门坐	qa_bus
9号线守车在哪个门坐	qa_bus
9号线临快在哪个门坐	qa_bus
9号线班车在谁人门坐	qa_bus
9号线夜车在谁门坐	qa_bus
9号线夜车在哪个门坐	qa_bus
9号线公车在哪个门坐	qa_bus
9号线空车在哪个门坐	qa_bus
9号线班车到哪个地铁站	qa_bus
9号线专用车到哪个地铁站	qa_bus
9号线慢车到哪个地铁站	qa_bus
9号线特快到何许人也质检站	qa_bus
9号线班车到谁个雷达站	qa_bus
9号线私车到哪个地铁站	qa_bus
9号线班车到何许人也中继站	qa_bus
9号线餐车到谁个地铁站	qa_bus
9号线空车到哪个地铁站	qa_bus
9号线班车到谁人地铁站	qa_bus
今晚12号线有班车吗	qa_bus
今晨12号线有班车吗	qa_bus
今夜12号线有班车吗	qa_bus
今晚12号线有私家车吗	qa_bus
今宵12号线有班车吗	qa_bus
今晚12号线有空车吗	qa_bus
今晚12号线有专车吗	qa_bus
今晚12号线有早班车吗	qa_bus
今晚12号线有末班车吗	qa_bus
今宵12号线有专车吗	qa_bus
12号线班车在哪个门坐	qa_bus
12号线慢车在哪个门坐	qa_bus
12号线特快在哪个门坐	qa_bus
12号线首车在哪个门坐	qa_bus
12号线班车在谁人门坐	qa_bus
12号线早班车在谁个门坐	qa_bus
12号线临快在谁门坐	qa_bus
12号线餐车在哪个门坐	qa_bus
12号线夜车在哪个门坐	qa_bus
12号线末班车在哪个门坐	qa_bus
12号线班车到哪个地铁站	qa_bus
12号线班车到何人地铁站	qa_bus
12号线早车到哪个泵站	qa_bus
12号线班车到谁人地铁站	qa_bus
12号线班车到哪个停车站	qa_bus
12号线守车到哪个地铁站	qa_bus
12号线班车到谁地铁站	qa_bus
12号线班车到哪个换流站	qa_bus
12号线班车到哪个航天站	qa_bus
12号线临快到哪个地铁站	qa_bus
班车几分钟一班	qa_bus
公车几分钟一班	qa_bus
晚车几分钟一班	qa_bus
名车几分钟一班	qa_bus
私家车几分钟一班	qa_bus
空车几分钟一班	qa_bus
专车几分钟一班	qa_bus
首车几分钟一班	qa_bus
头班车几分钟一班	qa_bus
私车几分钟一班	qa_bus
我坐1号线8点的班车，大概什么时候到公司	qa_bus
我坐1号线8点的班车，大概嘿时候到公司	qa_bus
我坐1号线8点的班车，大概哟时候到公司	qa_bus
我坐1号线8点的特快，大概什么时候到商厦	qa_bus
我坐1号线8点的班车，光景什么时候到公司	qa_bus
我坐1号线8点的班车，约摸什么时候到供销社	qa_bus
我坐1号线8点的空车，大概什么时候到公司	qa_bus
我坐1号线8点的班车，大概什么时候到营业所	qa_bus
我坐1号线8点的班车，大概哎哟时候到公司	qa_bus
我坐1号线8点的班车，大概哎呀下到公司	qa_bus
下一班班车什么时候开走	qa_bus
下一班临快什么时候开走	qa_bus
下一班班车嘿时候开走	qa_bus
下一班班车什么天时开走	qa_bus
下一班餐车嘿当儿背离	qa_bus
下一班班车哎哟时候开走	qa_bus
下一班临快什么时分开走	qa_bus
下一班班车哎时候离开	qa_bus
下一班特快什么时候开走	qa_bus
下一班专用车什么时候开走	qa_bus
几点有班车？	qa_bus
几点有空车？	qa_bus
几点有夜车？	qa_bus
几点有守车？	qa_bus
几点有头班车？	qa_bus
几点有公车？	qa_bus
几点有慢车？	qa_bus
几点有首车？	qa_bus
几点有临快？	qa_bus
几点有特快？	qa_bus
班车几点？	qa_bus
慢车几点？	qa_bus
晚车几点？	qa_bus
快车几点？	qa_bus
空车几点？	qa_bus
早车几点？	qa_bus
临快几点？	qa_bus
早班车几点？	qa_bus
私家车几点？	qa_bus
夜车几点？	qa_bus
今天晚上有班车么	qa_bus
今天晚上班车	qa_bus
今天晚上有班车	qa_bus
明天早上有班车么	qa_bus
明天早上有班车	qa_bus
明天早上班车	qa_bus
晚上班车几点	qa_bus
早上班车几点	qa_bus
班车在哪里上车	qa_bus
班车哪里	qa_bus
班车在哪里	qa_bus
班车可以到哪里	qa_bus
班车可以到	qa_bus
班车可以	qa_bus
晚上9点下班还有班车吗	qa_bus
晚上9点下班还有班车	qa_bus
12号线班车中间停其他地铁站吗？	qa_bus
12号线班车中间其他地铁站吗	qa_bus
12号线班车中间停其他地铁站吗	qa_bus
12号线班车中间停其他地铁站	qa_bus
12号线班车中间其他地铁站	qa_bus
我15分钟后想坐9号线的班车来得及吗	qa_bus
我15分钟想坐9号线班车来得及	qa_bus
我15分钟想坐9号线的班车来得及	qa_bus
我15分钟后想坐9号线的班车来得及	qa_bus
我15分钟后想坐9号线班车来得及	qa_bus
我15分钟坐9号线的班车来得及	qa_bus
我15分钟后坐9号线的班车来得及	qa_bus
我15分钟后坐9号线班车来得及	qa_bus
我15分钟坐9号线班车来得及	qa_bus
今晚2号线有班车吗	qa_bus
今晚2号线有班车	qa_bus
今晚2号线班车	qa_bus
2号线班车在哪个门坐	qa_bus
2号线班车在哪个	qa_bus
2号线班车哪个门	qa_bus
2号线班车在哪个门	qa_bus
2号线班车哪个	qa_bus
2号线班车到哪个地铁站	qa_bus
2号线班车到哪个	qa_bus
2号线班车哪个	qa_bus
今晚9号线有班车吗	qa_bus
今晚9号线有班车	qa_bus
今晚9号线班车	qa_bus
9号线班车在哪个门坐	qa_bus
9号线班车在哪个门	qa_bus
9号线班车在哪个	qa_bus
9号线班车哪个	qa_bus
9号线班车哪个门	qa_bus
9号线班车到哪个地铁站	qa_bus
9号线班车到哪个	qa_bus
9号线班车哪个	qa_bus
今晚12号线有班车吗	qa_bus
今晚12号线有班车	qa_bus
今晚12号线班车	qa_bus
12号线班车在哪个门坐	qa_bus
12号线班车在哪个门	qa_bus
12号线班车哪个门	qa_bus
12号线班车哪个	qa_bus
12号线班车在哪个	qa_bus
12号线班车到哪个地铁站	qa_bus
12号线班车哪个	qa_bus
12号线班车到哪个	qa_bus
班车几分钟一班	qa_bus
我坐1号线8点的班车，大概什么时候到公司	qa_bus
坐1号线8点的班车，大概什么时候到	qa_bus
我坐1号线8点班车，大概什么时候到	qa_bus
我坐1号线8点班车大概什么时候到	qa_bus
坐1号线8点班车，大概什么时候到	qa_bus
我坐1号线8点的班车，大概什么时候到	qa_bus
坐1号线8点的班车，大概什么时候	qa_bus
我坐1号线8点的班车，大概什么时候	qa_bus
我坐1号线8点的班车大概什么时候	qa_bus
我坐1号线8点班车，大概什么时候	qa_bus
下一班班车什么时候开走	qa_bus
一班班车什么时候	qa_bus
下一班班车什么时候	qa_bus
几点有班车？	qa_bus
几点班车	qa_bus
几点有班车	qa_bus
班车几点？	qa_bus
今天晚上有班车么	qa_bus
明天早上有班车么	qa_bus
晚上班车几点	qa_bus
早上班车几点	qa_bus
班车在哪里上车	qa_bus
班车可以到哪里	qa_bus
晚上9点下班还有班车吗	qa_bus
12号线班车中间停其他地铁站吗？	qa_bus
我15分钟后想坐9号线的班车来得及吗	qa_bus
今晚2号线有班车吗	qa_bus
2号线班车在哪个门坐	qa_bus
2号线班车到哪个地铁站	qa_bus
今晚9号线有班车吗	qa_bus
9号线班车在哪个门坐	qa_bus
9号线班车到哪个地铁站	qa_bus
今晚12号线有班车吗	qa_bus
12号线班车在哪个门坐	qa_bus
12号线班车到哪个地铁站	qa_bus
班车几分钟一班	qa_bus
我坐1号线8点的班车，大概什么时候到公司	qa_bus
下一班班车什么时候开走	qa_bus
几点有班车？	qa_bus
班车几点？	qa_bus
做客孩子临走时带走几只玩具，我的孩子抗拒并一直哭，要怎么开导？	qa_others
在四大做税务的工作体验如何？	qa_others
什么时候你觉得作为一名军人很自豪很值得？	qa_others
如何把校园爱情坚持下去？男生可能在毕业的很长一段时间内都是一无所有的，怎么办呢？该怎样对女生好呢？	qa_others
如何评价电视剧《雍正王朝》？	qa_others
为什么美漫里的超级英雄大都性生活混乱？	qa_others
部分刘诗雯粉丝为什么一直对丁宁有很大的负面评论？	qa_others
你还记得自己认识的第一个“声优”吗？	qa_others
养很多花是什么体验？	qa_others
怎样对喜欢的女生好，才让她感觉无压力？	qa_others
怎么才能彻底抛开穆斯林的身份？	qa_others
你手机里有什么好看的图片？	qa_others
被父性侵，如何给予警示？（已不需要回答，明白了答案和与人沟通，谢谢大家的回答）?	qa_others
有哪些值得一生推的高端眼影产品？	qa_others
和一个性欲低的女人生活在一起是什么体验？	qa_others
失恋后走出来是一种怎样的感觉？	qa_others
如何伺候相声板块的众大V？	qa_others
有没有什么兼职利用下班后闲暇时间做一做就能达到每月三千左右收入的?	qa_others
在哪儿买信托最好？	qa_others
SNH48的赵嘉敏个人到底有什么魅力？	qa_others
如何评价《三体》获得雨果奖最佳长篇小说？	qa_others
「轻松筹」捐钱可信吗？	qa_others
一个人住，晚上吃什么？	qa_others
如何看待腾讯今日话题《占道暴走团不应为被撞负全责》？	qa_others
养小鹿犬或者吉娃娃是什么样的体验呢？	qa_others
新生儿由母乳和配方奶喂养，需要额外补充DHA吗？如需要，是鱼油好还是藻油好？哪个牌子的安全些？	qa_others
有什么样特征或特质的男生你不会和他谈恋爱？（前提是你喜欢他）？	qa_others
如何评价“萌码”这个网站？	qa_others
如何看待武汉的大暴雨造成如此后果？	qa_others
如何接吻男票会硬？	qa_others
为什么说长征是「伟大的」？	qa_others
剩下59天高考如何提高数学？	qa_others
有哪些10元以下的实用文艺小物件？	qa_others
金庸小说里最萌的人物是谁？	qa_others
考研结束，你有什么想说的？	qa_others
如何理解马尔克斯《苦妓回忆录》？	qa_others
留学生代购风险那么大为什么不去打工？	qa_others
如何看待【饿了么社论】:但愿你心有所持，温和坚定？	qa_others
国外色情行业管理体系和产业链是怎样的？	qa_others
你最后悔买的小米产品是哪一个？	qa_others
现实中车真的可以爬上45°坡吗？	qa_others
如何评价老罗的锤子科技对OpenSSL基金会捐款100万元这件事？	qa_others
中国女生是否不如日本、韩国女生优秀？	qa_others
你们见过最抠门的老板什么样子？	qa_others
如何评价10月日剧Chef～三星校餐？	qa_others
如何评价语c？blc真的会对青少年成长产生负面影响吗？	qa_others
大二迷茫学生对考研和人生的困惑?	qa_others
高考复读会遇到哪些困难？我的复读理由充不充足？	qa_others
闭关锁国的日本，为什么会一眨眼，成了对外侵伐的罪恶之国？	qa_others
你最性感而又不失保守的照片是哪张？	qa_others
二本学校就不是学校了吗？	qa_others
韩国化妆品到底怎么样呢？	qa_others
男同性恋真的分「攻」、「受」吗？	qa_others
大学生最可行的自费摩托车旅行方案是？	qa_others
合肥有哪些不错的IT公司？	qa_others
电子商务的现状?	qa_others
有哪些好看的明清小说？	qa_others
做爱时女人在想什么？	qa_others
中国股市这一轮暴跌导致了中产阶级和平民怎么样的损失？	qa_others
技术移民加拿大有什么条件？	qa_others
《南方周末》这四个字对你意味着什么？	qa_others
白银连环杀人案犯高承勇是个什么样的人？怎样分析他的心理？	qa_others
有哪些适合家长学习的儿童教育书籍？	qa_others
中国有哪些小而美的城市？	qa_others
古生物学家在缅甸琥珀市场发现了含有完整恐龙尾巴的琥珀有何重大意义？	qa_others
人权重要还是通过打土豪分田地重要？	qa_others
杂志谈到越南女性地位低，儿子吃饭后母亲才能吃是真的吗？	qa_others
我们新开了家早教中心，可是一直招不到合适的老师，怎么办？	qa_others
你听过的三观极正的一句话是？	qa_others
说话语速快的人是否更聪明？	qa_others
自己当老板真的像看起来那么美好么？	qa_others
哪些纪录片可以称为「神作」？	qa_others
染发烫发真的会导致白血病吗？	qa_others
一个人的人心究竟能有多坏？	qa_others
男朋友总是说忙，是不是不爱我了？	qa_others
视力正常的人如何提高视力？	qa_others
问答社区用户如何参观问答社区办公室，是否有开放日之类的活动？	qa_others
如何看待Selina（任家萱）离婚？	qa_others
怎么看待网上爆出的南京农业大学动物实验事件？	qa_others
为什么会有女人只因为怀有两个月的身孕就可以一而再再而三的原谅男人出轨？	qa_others
老干妈、小肥羊火锅底料这些东西能放旅行箱里带过海关吗？	qa_others
准备复读，暑假应该怎么复习？	qa_others
有没有人跟我一样，心里忘不掉前任的？不管换了几个对象，那个人就是释怀不了？请问应该怎么解决?	qa_others
宜家哪些产品不值得买？	qa_others
为什么朝鲜能维持统治这么久？	qa_others
你认为《银魂》里励志或感人的对白是哪段？	qa_others
「强行污」是一种怎样的体验？	qa_others
请问，我的婚姻很差么？老公条件和感情也很差么？	qa_others
请问名字三十四划大都活不过六十岁这种说法可靠吗？有依据吗？	qa_others
被妈妈打屁股是一种怎样的体验？	qa_others
哪种锻炼方式最能让程序员远离亚健康？	qa_others
颧骨内推是怎样一种手术？	qa_others
彭德怀和麦克阿瑟，谁的军事统帅水平更高？	qa_others
交往四年的男朋友，经常莫名其妙地打我，怎么办？	qa_others
丈母娘很作，常在老婆面前说我不好，影响夫妻感情，怎么处理？	qa_others
被篡改的历史教科书在日本的普及率大概是多少？	qa_others
如何看待党报的评论「中国已不可能落入拉美式『中等收入陷阱』」？	qa_others
肾结石有什么症状？	qa_others
为什么我无法分辨男生是否帅？	qa_others
如何评价papi酱的长相？古典美女貌似不是，办公室女郎貌似不是	qa_others
做客孩子临走时带走几只玩具，我的孩子抗拒并一直哭，要怎么开导？	qa_others
聘孩子临走时随带几只玩具，我的孩子抗拒并一直哭，要岂开导？	qa_others
做客孩子临走时带走几只玩具，我的男女抗拒并一直哭，要岂开导？	qa_others
寻亲访友孩子临走时牵几只玩具，我的孩子抗拒并一直哭，要怎么开导？	qa_others
做客孩子临走时带走几只玩具，我的孩子抗拒并一直哭，要庸诱？	qa_others
做客孩子临走时带走几只玩意儿，我的孩子抗拒并一直哭，要怎么开导？	qa_others
做客孩子临走时携家带口几只玩具，我的孩子抗拒并一直哭，要怎么开导？	qa_others
做客孩子临走时带走几只玩具，我的孩子抗并一直哭，要怎么开导？	qa_others
做客孩临走时带走几只玩具，我的孩子抗拒并一直哭，要怎么开导？	qa_others
做客孩子临走时带走几只玩具，我的孩子违抗并直接哭，要怎么开导？	qa_others
在四大做税务的工作体验如何？	qa_others
在四大做税务的干活体验如何？	qa_others
在四大做税务的行事体验如何？	qa_others
在四大做防务的工作体验如何？	qa_others
在四大做票务的工作体验如何？	qa_others
在四大做剧务的做事体验怎？	qa_others
在四大做内务的工作体验什么？	qa_others
在四大做税务的办事体验如何？	qa_others
在四大做商务的干活体验如何？	qa_others
在四大做税务的工作心得怎？	qa_others
什么时候你觉得作为一名军人很自豪很值得？	qa_others
什么时候你当作为一名军人很自豪很犯得着？	qa_others
好家伙时候你觉得作为一名军人很自豪很值得？	qa_others
什么时候你觉得作为一名军人很超然很值得？	qa_others
什么时候你觉得作为一名武人很自豪很犯得上？	qa_others
什么时候你觉得作为一名军人很自豪很犯得上？	qa_others
什么时候你以为作为一名军人很自豪很犯得着？	qa_others
哎早晚你觉得作为一名军人很自豪很值得？	qa_others
什么际你以为用作一名武夫很自豪很值得？	qa_others
什么时候你觉着作为一名军人很自豪很值得？	qa_others
如何把校园爱情坚持下去？男生可能在毕业的很长一段时间内都是一无所有的，怎么办呢？该怎样对女生好呢？	qa_others
如何把校园爱情坚持下去？男生可能在毕业的很长一段时间内都是一无所有的，怎么办呢？该怎么着对女生好呢？	qa_others
如何把校园爱情坚持下去？男生可能在毕业的很长一段时间内都是两手空空的，怎么办呢？该怎样对双差生好呢？	qa_others
如何把校园爱情坚持下去？男生或许在毕业的很长一段时间内都是贫病交迫的，怎么办呢？该怎么对优秀生好呢？	qa_others
如何把校园爱情坚持下去？劣等生可能在毕业的很长一段时间内都是一无所有的，怎么办呢？该怎样对女生好呢？	qa_others
如何把校园爱情坚持下去？男生可能在毕业的很长一段时间内都是衣不蔽体的，怎么办呢？该怎样对女生好呢？	qa_others
如何把校园爱情坚持下去？男生可能在毕业的很长一段时间内都是衣不蔽体的，怎么办呢？该怎样对毕业生好呢？	qa_others
如何把校园爱情坚持下去？男生可能在毕业的很长一段时间内都是一无所有的，怎么办呢？该哪样对女生好呢？	qa_others
怎的把校园爱情坚持下去？男生指不定在结业的很长一段时间内都是一无所有的，怎么办呢？该怎样对女生好呢？	qa_others
如何把校园爱情坚持下去？男生可能在毕业的很长一段时间内都是两手空空的，怎么办呢？该怎样对后进生好呢？	qa_others
如何评价电视剧《雍正王朝》？	qa_others
如何评价连续剧《雍正王朝》？	qa_others
如何评价电视剧《雍正时》？	qa_others
如何评价地方戏《雍正朝代》？	qa_others
如何评价电视剧《雍正朝》？	qa_others
如何品头论足电视剧《雍正朝代》？	qa_others
如何评价电视剧《雍正代》？	qa_others
怎样评价电视剧《雍正王朝》？	qa_others
如何评价电视剧《雍正朝代》？	qa_others
什么评价电视剧《雍正王朝》？	qa_others
为什么美漫里的超级英雄大都性生活混乱？	qa_others
为什么美漫里的超级身先士卒大都性生活混乱？	qa_others
为什么美漫里的超级英雄大都性生活忙乱？	qa_others
为什么美漫里的超级英雄大都性生活狼藉？	qa_others
为什么美漫里的超级英雄大都房事混乱？	qa_others
为什么美漫里的超级英雄大都性生活拉杂？	qa_others
为什么美漫里的超级英雄多性生活混乱？	qa_others
为什么美漫里的超级临危不惧大都性生活庞杂？	qa_others
何以美漫里的超级大胆大都性生活撩乱？	qa_others
为啥美漫里的极品大胆大抵性生活混乱？	qa_others
部分刘诗雯粉丝为什么一直对丁宁有很大的负面评论？	qa_others
部分刘诗雯粉丝何故一直对丁宁有很大的负面评论？	qa_others
部分刘诗雯粉丝为什么第一手对丁宁有很大的负面评论？	qa_others
部分刘诗雯粉丝怎一直对丁宁有很大的负面评论？	qa_others
部分刘诗雯粉丝怎么一直对丁宁有很大的负面评论？	qa_others
部分刘诗雯粉为什么一直对丁宁有很大的负面评论？	qa_others
部分刘诗雯粉丝为什么一直对嘱事有很大的阴暗面评论？	qa_others
部分刘诗雯粉丝为什么一直对丁宁有很大的负面品头论足？	qa_others
组成部分刘诗雯粉丝为什么一直对丁宁有很大的负面评论？	qa_others
部分刘诗雯粉丝为什么一直对丁宁有很大的阴暗面评论？	qa_others
你还记得自己认识的第一个“声优”吗？	qa_others
你还记得好认识的第一个“声优”吗？	qa_others
你还记得协调认识的第一个“声优”吗？	qa_others
你还记自己认识的第一个“声优”吗？	qa_others
你还记得自己认得的第一个“声优”吗？	qa_others
你还记忆调谐认识的第一个“声优”吗？	qa_others
你还记得大团结认识的第一个“声优”吗？	qa_others
你还记忆自己认得的第一个“声优”吗？	qa_others
你还记得上下一心认识的第一个“声优”吗？	qa_others
你还记得自己认的第一个“声优”吗？	qa_others
养很多花是什么体验？	qa_others
养很多花是嗬哟心得？	qa_others
养很多花是什么心得？	qa_others
养为数不少花是嗬哟经验？	qa_others
养不在少数花是什么心得？	qa_others
养诸多花是什么体验？	qa_others
养有的是花是什么体验？	qa_others
养重重花是什么体验？	qa_others
养很多花是什么经验？	qa_others
养众花是什么体验？	qa_others
怎样对喜欢的女生好，才让她感觉无压力？	qa_others
怎样对喜爱的女生好，才让她感觉无压力？	qa_others
怎么对喜欢的三好生好，才让她感觉无压力？	qa_others
安对喜欢的女生好，才让她感觉无压力？	qa_others
怎么对喜欢的女生好，才让她深感无压力？	qa_others
怎样对喜欢的后进生好，才让她感觉无压力？	qa_others
怎样对喜欢的女生好，才让她觉无压力？	qa_others
怎样对喜欢的老生好，才让她感无压力？	qa_others
什么对好的保送生好，才让她深感无压力？	qa_others
怎么对喜欢的三好生好，才让她感觉无上压力？	qa_others
怎么才能彻底抛开穆斯林的身份？	qa_others
怎么才能彻底抛开穆斯林的身价？	qa_others
怎么才能彻底抛开回教徒的身份？	qa_others
怎么才能根本捐弃穆斯林的身份？	qa_others
怎么才能到顶抛开穆斯林的身份？	qa_others
庸才能彻底抛开回教徒的身份？	qa_others
怎生才能彻底毁弃穆斯林的身份？	qa_others
怎么才干翻然抛开穆斯林的身份？	qa_others
岂才能彻底捐弃穆斯林的位置？	qa_others
怎才能彻底抛开穆斯林的身份？	qa_others
你手机里有什么好看的图片？	qa_others
你手机里有什么好看的图纸？	qa_others
你手机里有什么好看的图籍？	qa_others
你手机里有嘻好看的图片？	qa_others
你无绳电话机里有什么好看的图片？	qa_others
你无绳机里有嘿好看的图片？	qa_others
你部手机里有什么好看的图片？	qa_others
你手机里有嗬哟为难的图纸？	qa_others
你手机里有什么好看的图？	qa_others
你大哥大里有什么好看的图片？	qa_others
被父性侵，如何给予警示？（已不需要回答，明白了答案和与人沟通，谢谢大家的回答）?	qa_others
被父性侵，如何给予提个醒？（已不需要答复，明白了答案和与人沟通，谢谢朱门的回答）?	qa_others
被父性侵，如何给予警示？（已不需要答疑，明白了答案和与人沟通，多谢名门的回）?	qa_others
被父性侵，如何给予警示？（已不需要回应，明白了答案和与人联络，多谢大家的回答）?	qa_others
被父性侵，如何给予警示？（已不需要解惑，明白了答案和与人沟通，有劳大家的回答）?	qa_others
被父性侵，如何予以警戒？（已不需要答复，明白了答案和与人沟通，有劳大家的回答）?	qa_others
被父性侵，安给予警戒？（已不需要回答，明了了答案和与人具结，谢谢大家的应对）?	qa_others
被父性侵，如何加之警示？（已不需要回答，明白了答案和与人牵连，谢谢朱门的回答）?	qa_others
被父性侵，怎给予警戒？（已不需要回答，明白了答案和与人沟通，谢谢大家的答话）?	qa_others
被父性侵，咋样给予警示？（已不需要回答，知情了答案和与人牵连，谢谢世族的对答）?	qa_others
有哪些值得一生推的高端眼影产品？	qa_others
有何如值得一生推的高端眼影制品？	qa_others
有哪些值得一生推的高端眼影成品？	qa_others
有焉值得一生推的高端眼影必要产品？	qa_others
有哪些犯得着一生推的高端眼影产品？	qa_others
有焉值得一辈子推的高端眼影产品？	qa_others
有何等值得终身推的高端眼影产品？	qa_others
有如何犯得上一生推的高端眼影产品？	qa_others
有哪些值得一生推的高端眼影出品？	qa_others
有怎么着值得一生推的高端眼影产品？	qa_others
和一个性欲低的女人生活在一起是什么体验？	qa_others
和一期性欲低的女人生活在一起是哎呀体验？	qa_others
和一个性欲低的女人生活在联名是什么体验？	qa_others
和一个性欲低的女人活在一起是什么体验？	qa_others
和一个性欲低的女人生活在联袂是什么体验？	qa_others
和一个性欲低的女人活着在合办是什么体验？	qa_others
和一下性欲低的女人活在一起是哎体验？	qa_others
和一番性欲低的女人生活在手拉手是什么体验？	qa_others
和一个性欲低的女人生活在一起是嗬体验？	qa_others
和一个肉欲低的女人生活在一起是什么体验？	qa_others
失恋后走出来是一种怎样的感觉？	qa_others
失学后走出来是一种何以的感觉？	qa_others
失恋后走出来是一种何以的感觉？	qa_others
失恋后走下是一种怎样的感觉？	qa_others
失恋后走沁是一种怎样的感觉？	qa_others
失学后走出来是一种怎样的感觉？	qa_others
失恋后走出来是一种争的备感？	qa_others
失恋后走出是一种何许的感觉？	qa_others
失恋后走出来是一种何等的感觉？	qa_others
失血后走下是一种争的觉得？	qa_others
如何伺候相声板块的众大V？	qa_others
哪伺候单口相声板块的众大V？	qa_others
如何伺候相声石头块的众大V？	qa_others
如何伺候相声集成块的众大V？	qa_others
如何伺候相声木块的众大V？	qa_others
怎么着伺候相声碎块的众大V？	qa_others
争伺候相声板块的众大V？	qa_others
怎么侍候单口相声板块的众大V？	qa_others
如何侍弄相声木块的众大V？	qa_others
何以伺候相声板块的众大V？	qa_others
有没有什么兼职利用下班后闲暇时间做一做就能达到每月三千左右收入的?	qa_others
有没有什么兼职利用下班后闲暇时间做一做就能达到每月三千反正收入的?	qa_others
有没有什么兼职利用下班后闲暇时间做一做就能达到某月三千左右收入的?	qa_others
有没有哎呀兼职行使下班后闲暇时间做一做就能达到某月三千左右创汇的?	qa_others
有没有什么兼任利用收工后闲暇流光做一做就能达到每月三千左右收入的?	qa_others
有没有什么兼职利用下工后闲暇时间做一做就能达到每月三千左不过收入的?	qa_others
有没有什么兼职利用下班后没事时间做一做就能达标每月三千左右收入的?	qa_others
有没有什么兼职利用下班后闲时间做一做就能达到每月三千左右收入的?	qa_others
有没有什么兼职利用下班后闲暇时间做一做就能达每月三千左右收入的?	qa_others
有没有什么兼职利用下班后闲暇时间做一做就能齐某月三千左右纯收入的?	qa_others
在哪儿买信托最好？	qa_others
在何处买信托最好？	qa_others
在哪儿买寄托尽？	qa_others
在何方买寄托最好？	qa_others
在哪儿买付托最好？	qa_others
在哪儿买嘱托卓绝？	qa_others
在哪儿买托付最好？	qa_others
在何地买托透顶？	qa_others
在何地买付托最好？	qa_others
在何处买信托太？	qa_others
SNH48的赵嘉敏个人到底有什么魅力？	qa_others
SNH48的赵嘉敏个私究有嗬魅力？	qa_others
SNH48的赵嘉敏个人到底有呀神力？	qa_others
SNH48的赵嘉敏个人到底有哟魅力？	qa_others
SNH48的赵嘉敏个人究有嗬哟药力？	qa_others
SNH48的赵嘉敏个人到底有什么药力？	qa_others
SNH48的赵嘉敏个私到底有什么神力？	qa_others
SNH48的赵嘉敏个人到底有什么魔力？	qa_others
SNH48的赵嘉敏个人到底有什么神力？	qa_others
SNH48的赵嘉敏个人到底有哎魅力？	qa_others
如何评价《三体》获得雨果奖最佳长篇小说？	qa_others
焉评价《三体》获得雨果奖最佳长篇小说？	qa_others
如何评论《三体》获得雨果奖最佳武侠小说？	qa_others
如何评价《三体》获得雨果奖上上寓言？	qa_others
如何评价《三体》获雨果奖最佳长篇小说？	qa_others
如何评价《三体》获得雨果奖极品长篇小说？	qa_others
何如评价《三体》获得雨果奖最佳长篇小说？	qa_others
如何评价《三体》拿走雨果奖最佳寓言？	qa_others
如何评价《三体》取得雨果奖最佳长篇小说？	qa_others
如何评论《三体》取雨果奖最佳短篇小说？	qa_others
「轻松筹」捐钱可信吗？	qa_others
「清闲自在筹」捐钱可信吗？	qa_others
「自在筹」捐钱互信吗？	qa_others
「轻松筹」捐钱取信吗？	qa_others
「轻松筹」捐钱互信吗？	qa_others
「自在筹」捐钱可信吗？	qa_others
「自由自在筹」捐钱取信吗？	qa_others
「优哉游哉筹」捐钱可信吗？	qa_others
「自由自在筹」捐钱可信吗？	qa_others
「逍遥自在筹」捐钱可信吗？	qa_others
一个人住，晚上吃什么？	qa_others
一番人住，夕吃啊？	qa_others
一个人住，夜幕吃什么？	qa_others
一番人住，晚上吃哎呀？	qa_others
一个人住，晚吃什么？	qa_others
一个人住，晚上吃嘿？	qa_others
一个人住，夜间吃什么？	qa_others
一个人住，晚上吃嘻？	qa_others
一个人住，夜晚吃什么？	qa_others
一期人住，晚上吃好家伙？	qa_others
如何看待腾讯今日话题《占道暴走团不应为被撞负全责》？	qa_others
哪些看待腾讯今日话题《占道暴走团不应为被撞负全责》？	qa_others
如何对腾讯今天话题《占道暴走团不应为被撞负全责》？	qa_others
安看待腾讯今儿话题《占道暴走团不应为被撞负全责》？	qa_others
如何看待腾讯今话题《占道暴走团不应为被撞负全责》？	qa_others
如何相待腾讯今日话题《占道暴走团不应为被撞负全责》？	qa_others
如何待腾讯今日话题《占道暴走团不应为被撞负全责》？	qa_others
什么看待腾讯今日话题《占道暴走团不应为被撞负全责》？	qa_others
何等看待腾讯今儿话题《占道暴走团不应为被撞负全责》？	qa_others
如何对腾讯今日课题《占道暴走团不应为被撞负全责》？	qa_others
养小鹿犬或者吉娃娃是什么样的体验呢？	qa_others
养小鹿犬或者吉娃娃是什么样的感受呢？	qa_others
养小鹿犬或者吉娃娃是何等的体验呢？	qa_others
养小鹿犬或者吉娃娃是咋样的经验呢？	qa_others
养小鹿犬要么吉娃娃是什么样的体验呢？	qa_others
养小鹿犬或者吉娃娃是什么样的心得呢？	qa_others
养小鹿犬或者吉娃娃是咋样的体验呢？	qa_others
养小鹿犬或者吉娃娃是如何的体验呢？	qa_others
养小鹿犬或者吉娃娃是什么样的体会呢？	qa_others
养小鹿犬或吉娃娃是什么样的感受呢？	qa_others
新生儿由母乳和配方奶喂养，需要额外补充DHA吗？如需要，是鱼油好还是藻油好？哪个牌子的安全些？	qa_others
新生儿由奶品和配方奶喂养，需要外加补充DHA吗？如需要，是鱼油好要藻油好？谁牌子的安全些？	qa_others
新生儿由母乳和配方奶喂，需要额外补充DHA吗？如需，是鱼油好还是藻油好？哪位词牌的安全些？	qa_others
新生儿由母乳和配方奶喂养，需要额外补充DHA吗？如亟需，是鱼油好还是藻油好？哪个诗牌的安如泰山些？	qa_others
新生儿由母乳和配方奶喂养，需要附加补充DHA吗？如需要，是鱼油好还是藻油好？哪个牌子的安全些？	qa_others
新生儿由母乳和配药奶喂养，需要额外抵补DHA吗？如需要，是鱼油好还是藻油好？哪个牌子的安全些？	qa_others
新生儿由母乳和配方奶喂养，需要额外补充DHA吗？如需，是鱼油好还是藻油好？哪个牌子的安全些？	qa_others
新生儿由母乳和配方奶喂养，需要额外补充DHA吗？如需要，是鱼油好还是藻油好？哪个牌子的无恙些？	qa_others
新生儿由母乳和配方奶哺育，需要额外补充DHA吗？如需要，是鱼油好还是藻油好？哪个牌子的安全些？	qa_others
新生儿由母乳和配药奶喂养，需要额外补充DHA吗？如急需，是鱼油好还是藻油好？哪个牌子的安全些？	qa_others
有什么样特征或特质的男生你不会和他谈恋爱？（前提是你喜欢他）？	qa_others
有怎的特征或特质的在校生你决不会和他谈恋爱？（前提是你喜欢他）？	qa_others
有怎特征或特质的男生你不会和他谈恋爱？（前提是你欢喜他）？	qa_others
有怎特征或特质的优秀生你不会和他谈恋爱？（前提是你喜欢他）？	qa_others
有什么样特征或特质的劣等生你不会和他谈恋爱？（小前提是你好他）？	qa_others
有什么样特征或特质的后进生你不会和他谈恋爱？（前提是你喜欢他）？	qa_others
有什么样性状或特质的双特生你决不会和他谈恋爱？（前提是你欣赏他）？	qa_others
有什么样特征或特质的男生你不会和他恋爱？（大前提是你喜他）？	qa_others
有什么样特征或特质的劣等生你不会和他谈恋爱？（前提是你喜欢他）？	qa_others
有怎么着特征或特质的男生你不会和他谈恋爱？（前提是你希罕他）？	qa_others
如何评价“萌码”这个网站？	qa_others
焉评价“萌码”这网站？	qa_others
咋样评价“萌码”这个网站？	qa_others
怎样评价“萌码”这网站？	qa_others
如何评价“萌码”其一网站？	qa_others
哪边评价“萌码”这个网站？	qa_others
如何评价“萌码”斯网站？	qa_others
如何评价“萌码”这网站？	qa_others
咋样评价“萌码”者网站？	qa_others
何许评价“萌码”者网站？	qa_others
如何看待武汉的大暴雨造成如此后果？	qa_others
如何看待长沙的大暴雨致使如此后果？	qa_others
如何看待广州的大暴雨造成这一来后果？	qa_others
怎样对武汉的大暴雨致使如此后果？	qa_others
如何看待西安的大暴雨造成如此后果？	qa_others
如何看待银川的大暴雨造成如此产物？	qa_others
咋样看待武汉的大暴雨致使如此后果？	qa_others
怎么看待武汉的雷暴雨造成这一来结局？	qa_others
如何看待武汉的大暴雨造成这么着究竟？	qa_others
怎样看待武汉的大暴雨造成如此结局？	qa_others
如何接吻男票会硬？	qa_others
如何吻男票会硬？	qa_others
怎接吻男票会硬？	qa_others
怎么接吻男票会硬？	qa_others
何等亲男票会硬？	qa_others
何许接吻男票会硬？	qa_others
何以接吻男票会硬？	qa_others
如何亲吻男票会硬？	qa_others
怎么着吻男票会硬？	qa_others
何等接吻男票会硬？	qa_others
为什么说长征是「伟大的」？	qa_others
为什么说飘洋过海是「伟大的」？	qa_others
缘何说长征是「英雄的」？	qa_others
为什么说长征是「奇伟的」？	qa_others
何以说远征是「伟大的」？	qa_others
为什么说远征是「气势磅礴的」？	qa_others
怎么说远征是「广远的」？	qa_others
干什么说长征是「伟大的」？	qa_others
为什么说远涉重洋是「伟大的」？	qa_others
为什么说长征是「光前裕后的」？	qa_others
剩下59天高考如何提高数学？	qa_others
剩下59天高考如何增高数学？	qa_others
剩下59天测试该当何论提高生理学？	qa_others
剩下59天免试怎提高数学？	qa_others
剩下59天高考何以提高地热学？	qa_others
剩下59天高考何许提高数学？	qa_others
结余59天高考何如如虎添翼数学？	qa_others
剩下59天口试如何提高生态学？	qa_others
剩下59天高考何许增长地质学？	qa_others
剩余59天高考如何提高校勘学？	qa_others
有哪些10元以下的实用文艺小物件？	qa_others
有哪些10元以下的启用文学小物件？	qa_others
有什么样10元以下的实用文学小物件？	qa_others
有哪些10元以下的试用文学小物件？	qa_others
有哪些10元以下的并用文艺小物件？	qa_others
有安10元以下的租用文艺小物件？	qa_others
有哪些10元之下的实用文艺小物件？	qa_others
有哪些10元以下的实用文学小物件？	qa_others
有哪些10元以下的军用文学小物件？	qa_others
有哪些10元偏下的实用文学小物件？	qa_others
金庸小说里最萌的人物是谁？	qa_others
金庸闲书里最萌的人物是谁？	qa_others
金庸小说书里最萌的人物是谁？	qa_others
金庸小说书里最萌的人士是谁？	qa_others
金庸小说里最萌的人选是谁？	qa_others
金庸小说里最萌的人氏是谁？	qa_others
金庸闲书里最萌的人选是谁？	qa_others
金庸小说里最萌的人士是谁？	qa_others
金庸小说书里最萌的士是谁？	qa_others
金庸小说书里最萌的人氏是谁？	qa_others
考研结束，你有什么想说的？	qa_others
考上结束，你有啊想说的？	qa_others
考研一了百了，你有什么想说的？	qa_others
考研结束，你有哎呀想说的？	qa_others
考研毕，你有嗬哟想说的？	qa_others
考研收束，你有嗬想说的？	qa_others
考学收场，你有哎哟想说的？	qa_others
升学煞，你有什么想说的？	qa_others
考研告竣，你有什么想说的？	qa_others
考学结束，你有什么想说的？	qa_others
如何理解马尔克斯《苦妓回忆录》？	qa_others
咋样解马尔克斯《苦妓回忆录》？	qa_others
如何解马尔克斯《苦妓回忆录》？	qa_others
何以理解马尔克斯《苦妓回忆录》？	qa_others
如何知道马尔克斯《苦妓回忆录》？	qa_others
怎样明了马尔克斯《苦妓实录》？	qa_others
如何理解马尔克斯《苦妓实录》？	qa_others
如何亮马尔克斯《苦妓回忆录》？	qa_others
该当何论理解马尔克斯《苦妓回忆录》？	qa_others
何许理解马尔克斯《苦妓回忆录》？	qa_others
留学生代购风险那么大为什么不去打工？	qa_others
留学生并购风险那大为什么不去上岗？	qa_others
留学生代购风险那末大为什么不去打工？	qa_others
留学生代购风险那么大为什么不去务工？	qa_others
留学生代购风险那么大干什么不去打工？	qa_others
留学生代购高风险那么大为什么不去上岗？	qa_others
留学生代购风险这就是说大为什么不去打工？	qa_others
本专科生代购风险那么大为什么不去打工？	qa_others
留学生代购风险那末大为什么不去上岗？	qa_others
大中学生套购风险那么大为什么不去打工？	qa_others
如何看待【饿了么社论】:但愿你心有所持，温和坚定？	qa_others
何以相待【饿了么社论】:但愿你心有所持，温和坚定？	qa_others
如何待遇【饿了么社论】:指望你心有所持，温和坚苦？	qa_others
何如看待【饿了么社评】:但愿你心有着持，温和坚定？	qa_others
怎么看待【饿了么社论】:但愿你心有所持，和蔼坚定？	qa_others
怎样看待【饿了么社论】:但愿你心怀有持，温润坚定？	qa_others
该当何论看待【饿了么社论】:但愿你心备持，好说话儿坚定？	qa_others
怎么着待【饿了么社论】:但愿你心有所持，温柔坚定？	qa_others
如何对【饿了么社论】:要你心有所持，温和坚定？	qa_others
怎样看待【饿了么社论】:但愿你心有所持，温和坚定？	qa_others
国外色情行业管理体系和产业链是怎样的？	qa_others
海外色情行业管理体系和产业链是怎样的？	qa_others
域外色情行业管理体系和产业链是何如的？	qa_others
国外色情行业管理体系和产业链是怎么着的？	qa_others
国外色情行业管理体系和钥匙环是怎样的？	qa_others
国外色情行业管理体系和产业链是何许的？	qa_others
海外色情行业管理体系和产业链是该当何论的？	qa_others
域外色情行业管理体系和产业链是怎样的？	qa_others
国外色情行业管理体系和产业链是怎的的？	qa_others
国外色情行业管理体系和产业链是何等的？	qa_others
你最后悔买的小米产品是哪一个？	qa_others
你最后悔买的小米制品是哪一番？	qa_others
你最吃后悔药买的小米产品是哪一个？	qa_others
你最悔不当初买的小米产品是哪一个？	qa_others
你最后悔买的粳米成品是哪一个？	qa_others
你最悔恨买的小米产品是哪一个？	qa_others
你最痛悔买的小米活是哪一下？	qa_others
你最后悔买的小米必要产品是哪一个？	qa_others
你最后悔买的小米产品是哪一下？	qa_others
你最后悔买的小米产品是哪一期？	qa_others
现实中车真的可以爬上45°坡吗？	qa_others
现实中车真的堪爬上45°坡吗？	qa_others
现实中车真正可以爬上45°坡吗？	qa_others
求实中车真的得爬上45°坡吗？	qa_others
言之有物中车委实可以爬上45°坡吗？	qa_others
具体中车真的何尝不可爬上45°坡吗？	qa_others
切实可行中车真的可以爬上45°坡吗？	qa_others
言之有物中车真的可以爬上45°坡吗？	qa_others
现实中车真的得以爬上45°坡吗？	qa_others
切实中车真的可以爬上45°坡吗？	qa_others
如何评价老罗的锤子科技对OpenSSL基金会捐款100万元这件事？	qa_others
如何评价老罗的槌科技对OpenSSL青委会捐款100万元这件事？	qa_others
如何评价老罗的锤科技对OpenSSL基金会捐款100万元这件事？	qa_others
如何评头论足老罗的锤子科技对OpenSSL互助会赈款100万元这件事？	qa_others
如何评老罗的榔头科技对OpenSSL监事会捐款100万元这件事？	qa_others
怎的评价老罗的锤子科技对OpenSSL编委会捐款100万元这件事？	qa_others
哪褒贬老罗的锤子科技对OpenSSL基金会捐款100万元这件事？	qa_others
怎的评价老罗的锤子科技对OpenSSL基金会赃款100万元这件事？	qa_others
如何评价老罗的锤子科技对OpenSSL基金会集资款100万元这件事？	qa_others
该当何论评价老罗的锤子科技对OpenSSL基金会捐款100万元这件事？	qa_others
中国女生是否不如日本、韩国女生优秀？	qa_others
中国女生是不是不如日本、韩国女生优秀？	qa_others
中国毕业生是否不如日本、墨西哥保送生可以？	qa_others
中国女生是否不如日本、韩国女生要得？	qa_others
中国女生是否不如日本、韩国自费生优秀？	qa_others
中国女生是否与其说齐国、韩国女生优秀？	qa_others
中国女生是否不如南非共和国、韩国老生脍炙人口？	qa_others
中国女生是否与其日本、葡萄牙女生优秀？	qa_others
中国受助生是否不如日本、韩国毕业生优？	qa_others
中国女生是不是不如印度尼西亚、韩国考生优秀？	qa_others
你们见过最抠门的老板什么样子？	qa_others
你们见过最抠门的老板什么则？	qa_others
你们见过最抠门的小业主什么样子？	qa_others
你们见过最钱串子的老板什么样板？	qa_others
尔等见过最抠门的老板咦金科玉律？	qa_others
你们见过最抠门的老板哎哟样子？	qa_others
你们见过最铁算盘的老板什么规范？	qa_others
你们见过最抠门的老板娘什么样子？	qa_others
你们见过最抠门的财东什么样子？	qa_others
你们见过最数米而炊的老板什么样子？	qa_others
如何评价10月日剧Chef～三星校餐？	qa_others
何等讲评10月日剧Chef～三星校餐？	qa_others
怎么评价10月日剧Chef～八仙校餐？	qa_others
咋样品头论足10月日剧Chef～三星校餐？	qa_others
如何评价10月日剧Chef～福星校餐？	qa_others
什么评价10月日剧Chef～河神校餐？	qa_others
什么评价10月日剧Chef～三星校餐？	qa_others
如何评价10月日剧Chef～金刚校餐？	qa_others
如何品10月日剧Chef～三星校餐？	qa_others
如何评价10月日剧Chef～佛祖校餐？	qa_others
如何评价语c？blc真的会对青少年成长产生负面影响吗？	qa_others
何以评价语c？blc真的会对青少年成长产生负面影响吗？	qa_others
哪评价语c？blc真的会对青少年成人生负面影响吗？	qa_others
如何评价语c？blc真正会对青少年成长出负面影响吗？	qa_others
如何评价语c？blc确实会对青少年成长产生负面影响吗？	qa_others
如何品语c？blc真的会对弟子成长产生负面影响吗？	qa_others
如何评价语c？blc真的会对初生之犊成人产生负面影响吗？	qa_others
哪样臧否语c？blc真的会对青少年成长产生负面影响吗？	qa_others
如何评语c？blc真的会对小伙子成长发生负面影响吗？	qa_others
何等臧否语c？blc真的会对后生成长产生负面影响吗？	qa_others
大二迷茫学生对考研和人生的困惑?	qa_others
大二缥缈学生对考研和人生的困惑?	qa_others
大二迷茫学员对考上和人生的困惑?	qa_others
大二迷茫学童对考研和人生的迷惑不解?	qa_others
大二迷茫学生对升学和人生的困惑?	qa_others
大二惺忪学生对考研和人生的困惑?	qa_others
大二蒙胧学员对考研和人生的困惑?	qa_others
大二迷茫学生对考研和人生的何去何从?	qa_others
大二迷茫生对考研和人生的困惑?	qa_others
大二迷茫学生对考研和人生的迷惑不解?	qa_others
高考复读会遇到哪些困难？我的复读理由充不充足？	qa_others
测试复读会遇到该当何论困难？我的复读说辞充不充足？	qa_others
高考复读会遇到哪些困难？我的复读理由充不雄厚？	qa_others
自考重读会遇到哪些艰苦？我的复读理由充不充足？	qa_others
免试复读会遇到哪诸多不便？我的复读理由充不丰盈？	qa_others
科考复读会遇到怎么困难？我的复读说辞充不充足？	qa_others
面试复读会撞见何许困难？我的复读理由充不充足？	qa_others
口试复读会遇到哪些困难？我的复读理由充不充足？	qa_others
高考复读会碰面哪些困难？我的复读理充不充足？	qa_others
免试复读会遇到怎样清锅冷灶？我的重读理由充不充足？	qa_others
闭关锁国的日本，为什么会一眨眼，成了对外侵伐的罪恶之国？	qa_others
闭关自守的佛得角共和国，何故会一眨眼，成了对外侵伐的罪恶之国？	qa_others
闭关锁国的保加利亚，为什么会瞬，成了对外侵伐的十恶不赦之国？	qa_others
闭关锁国的刚果，为什么会一眨眼，成了对外侵伐的罪恶之国？	qa_others
闭关锁国的日本，干吗会一眨眼，成了对外侵伐的罪恶滔天之国？	qa_others
闭关锁国的赞比亚，为什么会一晃，成了对外侵伐的罪不容诛之国？	qa_others
闭关自守的巴西联邦共和国，为什么会一眨眼，成了对内侵伐的罪恶之国？	qa_others
闭关的日本，为什么会一眨眼，成了对内侵伐的罪恶之国？	qa_others
闭关锁国的日本，为什么会一转眼，成了对外侵伐的罪恶之国？	qa_others
闭关锁国的马来亚，何以会一眨眼，成了对外侵伐的五毒俱全之国？	qa_others
你最性感而又不失保守的照片是哪张？	qa_others
你最轻佻而又不失保守的影是哪张？	qa_others
你最性感而又不失墨守陈规的照片是哪张？	qa_others
你最性感而又不失迂的照片是哪张？	qa_others
你最癫狂而又不失迂腐的相片是哪张？	qa_others
你最轻佻而又不失保守的像是哪张？	qa_others
你最妖艳而又不失保守的照片是哪张？	qa_others
你最浪漫而又不失抱残守缺的照片是哪张？	qa_others
你最有伤风化而又不失保守的照片是哪张？	qa_others
你最性感而又不失固步自封的照片是哪张？	qa_others
二本学校就不是学校了吗？	qa_others
二本母校就不是学校了吗？	qa_others
二本全校就不是学校了吗？	qa_others
二本学校就错事学校了吗？	qa_others
二本该校就不是校了吗？	qa_others
二本学校就过错该校了吗？	qa_others
二本学校就不是院校了吗？	qa_others
二本学府就不是母校了吗？	qa_others
二本学校就不是母校了吗？	qa_others
二本黉就不是学校了吗？	qa_others
韩国化妆品到底怎么样呢？	qa_others
韩国化妆品到底何如呢？	qa_others
刚果民主共和国脂粉到底怎么样呢？	qa_others
韩国脂粉到底怎么样呢？	qa_others
韩国化妆品究竟怎么样呢？	qa_others
韩国脂粉究怎么样呢？	qa_others
韩国化妆品到底哪样呢？	qa_others
刚果共和国脂粉到底怎么呢？	qa_others
韩国化妆品究怎么样呢？	qa_others
塔吉克斯坦共和国脂粉到底哪呢？	qa_others
男同性恋真的分「攻」、「受」吗？	qa_others
男同性恋委分「攻」、「受」吗？	qa_others
男同性恋确确实实分「攻」、「受」吗？	qa_others
男同性恋的确分「攻」、「受」吗？	qa_others
男同性恋着实分「攻」、「受」吗？	qa_others
男同性恋真正分「攻」、「受」吗？	qa_others
男同性恋诚然分「攻」、「受」吗？	qa_others
男同性恋当真分「攻」、「受」吗？	qa_others
男同性恋审分「攻」、「受」吗？	qa_others
男同性恋实在分「攻」、「受」吗？	qa_others
大学生最可行的自费摩托车旅行方案是？	qa_others
大学生最可行的自费摩托车行旅提案是？	qa_others
大学生最可行的自费摩托车旅行提案是？	qa_others
大学生最可行的自费摩托车远足方案是？	qa_others
大学生最对症的自费摩托车旅行方案是？	qa_others
大中学生最可行的自费摩托车旅行方案是？	qa_others
博士生最灵验的自费摩托车旅行提案是？	qa_others
大学生最可行的自费摩托车旅行议案是？	qa_others
研修生最可行的自费摩托车旅行方案是？	qa_others
大学生最可行的自费摩托车行旅方案是？	qa_others
合肥有哪些不错的IT公司？	qa_others
呼和浩特有哪些天经地义的IT公司？	qa_others
昆明有怎么着不错的IT公司？	qa_others
贵阳有哪些不错的IT商社？	qa_others
合肥有哪些正确性的IT公司？	qa_others
重庆有哪些不错的IT公司？	qa_others
合肥有哪些是的的IT营业所？	qa_others
合肥有哪些不易的IT公司？	qa_others
拉萨有哪些头头是道的IT公司？	qa_others
福州有哪些得法的IT公司？	qa_others
电子商务的现状?	qa_others
电子商务的异状?	qa_others
有哪些好看的明清小说？	qa_others
有哪边好看的明清小说？	qa_others
有什么样尴尬的明清小说？	qa_others
有哪些难堪的明清小说？	qa_others
有哪些碍难的明清小说？	qa_others
有什么碍难的明清小说？	qa_others
有哪些为难的明清小说？	qa_others
有哪些尴尬的明清小说？	qa_others
有怎样好看的明清小说？	qa_others
有怎难堪的明清小说？	qa_others
做爱时女人在想什么？	qa_others
做爱时妻在想什么？	qa_others
做爱时女人在想啊？	qa_others
做爱时老婆在想什么？	qa_others
做爱时女人在想好家伙？	qa_others
做爱时爱人在想什么？	qa_others
做爱时女人在想呀？	qa_others
做爱时婆娘在想什么？	qa_others
做爱时老婆子在想什么？	qa_others
做爱时女人在想哎？	qa_others
中国股市这一轮暴跌导致了中产阶级和平民怎么样的损失？	qa_others
中国股市这一轮销价导致了中产阶级和平民如何的损失？	qa_others
中国书市这一轮下跌导致了地主阶级和平民什么的海损？	qa_others
华夏股市这一轮落导致了中产阶级和平民怎么着的损失？	qa_others
中国股市这一轮暴跌导致了中产阶级和庶怎么样的损失？	qa_others
中国股市这一轮暴跌导致了中产阶级和平民何以的损失？	qa_others
中国书市这一轮跌落导致了中产阶级和国民怎么样的损失？	qa_others
神州股市这一轮暴跌导致了中产阶级和平民怎么样的损失？	qa_others
中国书市这一轮跌导致了中产阶级和平民哪样的损失？	qa_others
中国股市这一轮暴跌导致了中产阶级和平民争的海损？	qa_others
技术移民加拿大有什么条件？	qa_others
技术移民挪威王国有什么条件？	qa_others
技术移民加拿大有嗬条件？	qa_others
技术移民孟加拉有什么条件？	qa_others
技术移民加拿大有啊条件？	qa_others
技术移民美国有什么准谱儿？	qa_others
技术移民加拿大有什么尺度？	qa_others
技术移民加拿大有什么格？	qa_others
技术移民斯洛伐克共和国有什么条件？	qa_others
技术移民加拿大有什么格木？	qa_others
《南方周末》这四个字对你意味着什么？	qa_others
《南方周末》这四个字对你象征什么？	qa_others
《南方周末》这四个字对你意味着哎哟？	qa_others
《南方周末》这四个字对你意味着呀？	qa_others
《南方周末》这四个字对你意味着好家伙？	qa_others
《南方周末》这四个字对你意味着啊？	qa_others
《南方周末》这四个字对你代表哎呀？	qa_others
《南方周末》这四个字对你意味着嗬？	qa_others
《南方周末》这四个字对你意味什么？	qa_others
《南方周末》这四个字对你意味着哎？	qa_others
白银连环杀人案犯高承勇是个什么样的人？怎样分析他的心理？	qa_others
银连环杀人案犯高承勇是个什么样的人？怎样解析他的心理？	qa_others
银连环杀人案犯高承勇是个什么的人？怎样分析他的心理？	qa_others
白银连环杀人案犯高承勇是个什么样的人？怎样析他的心理？	qa_others
足银连环杀人案犯高承勇是个什么样的人？怎样分析他的心理？	qa_others
白银藕断丝连命案犯高承勇是个焉的人？怎样分析他的心理？	qa_others
纹银连环杀人案犯高承勇是个什么样的人？哪边分析他的心理？	qa_others
白银连环杀人案犯高承勇是个什么样的人？怎样分析他的思？	qa_others
白银藕断丝连杀人案犯高承勇是个什么样的人？怎样分析他的心理？	qa_others
白银连环杀人案犯高承勇是个怎的人？怎样分析他的思维？	qa_others
有哪些适合家长学习的儿童教育书籍？	qa_others
有哪些严丝合缝家长学习的儿童教育书简？	qa_others
有哪些适合上下学习的儿童教育木简？	qa_others
有哪些适合父母学习的儿童教育书籍？	qa_others
有哪边适合家长学习的儿童教育书籍？	qa_others
有焉适合家长学习的儿童教育书籍？	qa_others
有哪些合考妣念书的儿童教育书籍？	qa_others
有哪样适合家长学习的儿童教育本本？	qa_others
有哪些适合家长学习的儿童教育书册？	qa_others
有何如适合家长学习的儿童教育书籍？	qa_others
中国有哪些小而美的城市？	qa_others
华有哪样小而美的城市？	qa_others
炎黄有哪些小而美的城市？	qa_others
中国有哪些小而美的都会？	qa_others
华有该当何论小而美的城市？	qa_others
礼仪之邦有怎么小而美的城市？	qa_others
华有什么小而美的城市？	qa_others
中国有哪些小而美的都市？	qa_others
中国有哪些小而美的都？	qa_others
神州有哪些小而美的城市？	qa_others
古生物学家在缅甸琥珀市场发现了含有完整恐龙尾巴的琥珀有何重大意义？	qa_others
古生物学家在缅甸琥珀市场发现了含有总体恐龙尾巴的琥珀有何重大意义？	qa_others
经济学家在缅甸琥珀商海发现了含有完整恐龙尾巴的琥珀有何重大意义？	qa_others
古生物学家在北爱尔兰琥珀市场发现了含有完整恐龙尾巴的琥珀有何重大意义？	qa_others
古生物学家在缅甸琥珀市场发现了含有完整鱼龙罅漏的琥珀有何重大意义？	qa_others
慈善家在菲律宾琥珀市面发觉了含有完好无恙恐龙尾巴的琥珀有何重大意义？	qa_others
古生物学家在阿塞拜疆共和国琥珀市场发现了蕴藏整整的鸭嘴龙狐狸尾巴的琥珀有何重大意义？	qa_others
古生物学家在缅甸琥珀市场窥见了蕴含完整鱼龙罅漏的琥珀有何重大意义？	qa_others
古生物学家在缅甸琥珀市场发现了含有共同体恐龙尾巴的琥珀有何重大意义？	qa_others
古生物学家在缅甸琥珀市场发现了含有完整鸭嘴龙漏洞的琥珀有何重大意义？	qa_others
人权重要还是通过打土豪分田地重要？	qa_others
表决权重要还是通过打土豪分田地要？	qa_others
责权利重要或通过打土豪分田地重要？	qa_others
人权重要还是经打土豪分田地重要？	qa_others
人权非同儿戏还是通过打土豪分境地重要？	qa_others
人权重要性或通过打土豪分田地重要？	qa_others
人权主要还是通过打土豪分田地性命交关？	qa_others
人权首要还是通过打土豪分田地重要？	qa_others
人权重要要通过打土豪分田地任重而道远？	qa_others
人权重要还是经过打土豪分田地重要？	qa_others
杂志谈到越南女性地位低，儿子吃饭后母亲才能吃是真的吗？	qa_others
记谈到利比亚女性地位低，幼子吃饭后母亲才能吃是真的吗？	qa_others
杂志谈到越南坤位低，儿子吃饭后娘亲才能吃是真的吗？	qa_others
杂志谈到越南女性地位低，儿子吃饭后母亲才能吃是着实吗？	qa_others
杂志谈到越南女性身份低，子吃饭后妈才能吃是真的吗？	qa_others
笔谈谈到阿根廷女性位置低，儿子吃饭后母亲才能吃是真的吗？	qa_others
杂志提及越南女性地位低，儿子吃饭后母亲才能吃是真的吗？	qa_others
笔谈谈到越南女性地位低，儿子偏后娘亲才能吃是真的吗？	qa_others
笔录谈到印度支那女性地位低，儿子吃饭后生母才能吃是真的吗？	qa_others
杂志谈到意大利女性位置低，儿子吃饭后母亲才能吃是真的吗？	qa_others
我们新开了家早教中心，可是一直招不到合适的老师，怎么办？	qa_others
吾辈新开了家早教中心，不过一直招不到合适的老师，怎么办？	qa_others
吾侪新开了家早教中心，而是一直招不到合适的老师，怎么办？	qa_others
我们新开了家早教中心，然则一直招不到合适的教书匠，怎么办？	qa_others
俺们新开了家早教中坚，可是一直招不到合适的老师，怎么办？	qa_others
我们新开了家早教挑大梁，可是直白招不到合适的师，怎么办？	qa_others
我们新开了家早教中心，可是一直招不到当的老师，怎么办？	qa_others
俺们新开了家早教中心，可是第一手招不到恰切的师长，怎么办？	qa_others
我们新开了家早教中心，可是一直招缺阵合适的教书匠，怎么办？	qa_others
咱新开了家早教中心，可是一直招不到合适的老师，怎么办？	qa_others
你听过的三观极正的一句话是？	qa_others
说话语速快的人是否更聪明？	qa_others
说话语速快的人是不是更聪明？	qa_others
讲语速快的人是否更聪明？	qa_others
语语速快的人是否更聪明？	qa_others
叙语速快的人是否更灵性？	qa_others
说话语速快的人是否更能者？	qa_others
言语速快的人是否更聪明？	qa_others
说话语速快的人是否更灵性？	qa_others
说话语速快的人是否更有头有脑？	qa_others
发话语速快的人是否更聪明？	qa_others
自己当老板真的像看起来那么美好么？	qa_others
和和气气当老板真的像看起来那么美好么？	qa_others
自己当老板着实像看起来那美好么？	qa_others
自己当老板真的像看起来那成气候么？	qa_others
上下一心当老板真的像看起来那么成气候么？	qa_others
燮当老板洵像看起来那么光明么？	qa_others
自己当老板真的像看起来那末美好么？	qa_others
友好当老板真像看起来那成气候么？	qa_others
友好当老板真的像看起来那么美好么？	qa_others
谐和当老板真的像看起来那末美好么？	qa_others
哪些纪录片可以称为「神作」？	qa_others
怎么着纪录片可以称为「神作」？	qa_others
哪些经济作物片可以称为「神作」？	qa_others
怎么样纪录片可以称为「神作」？	qa_others
怎故事片可以称之为「神作」？	qa_others
哪些纪录片得以称为「神作」？	qa_others
哪些短片足以称为「神作」？	qa_others
争纪录片可以称为「神作」？	qa_others
哪些示范片可以称为「神作」？	qa_others
哪边纪录片可以称为「神作」？	qa_others
染发烫发真的会导致白血病吗？	qa_others
染发烫发委会导致白血病吗？	qa_others
染发烫发真的会导致食管癌吗？	qa_others
染发烫发真的会造成白血病吗？	qa_others
染发烫发诚然会导致白血病吗？	qa_others
匀脸烫发洵会引致白血病吗？	qa_others
染发烫发真个会引致佝偻病吗？	qa_others
染发烫头确会导致白血病吗？	qa_others
染发烫发实在会导致白血病吗？	qa_others
整形烫发真的会引致白血病吗？	qa_others
一个人的人心究竟能有多坏？	qa_others
一期人的民情究竟能有多坏？	qa_others
一番人的人心究竟能有多坏？	qa_others
一个人的民情究竟能有多坏？	qa_others
一个人的人心到底能有多坏？	qa_others
一度人的人心究竟能有多坏？	qa_others
一个人的公意究能有多坏？	qa_others
一下人的人心究竟能有多坏？	qa_others
一个人的人心究能有多坏？	qa_others
一下人的民心究竟能有多坏？	qa_others
男朋友总是说忙，是不是不爱我了？	qa_others
情郎总是说忙，是不是不爱我了？	qa_others
男朋友连日说忙，是不是不爱我了？	qa_others
欢总是说忙，是不是不爱我了？	qa_others
男朋友连年说忙，是不是不爱我了？	qa_others
男朋友总是说忙，是否不爱我了？	qa_others
男朋友连接说忙，是不是不爱我了？	qa_others
男朋友接连不断说忙，是否不爱我了？	qa_others
男友总是说忙，是不是不爱我了？	qa_others
欢总是说忙，是否不爱我了？	qa_others
视力正常的人如何提高视力？	qa_others
视力正常化的人什么样提高目力？	qa_others
目力好端端的人哪些提高视力？	qa_others
眼力正常的人如何增长眼力？	qa_others
视力正常化的人安如虎添翼视力？	qa_others
视力常规的人如何提高视力？	qa_others
眼力正常的人什么样提高视力？	qa_others
视力正常的人如何三改一加强视力？	qa_others
视力正常的人哪些提高视力？	qa_others
眼神正常的人如何提高视力？	qa_others
问答社区用户如何参观问答社区办公室，是否有开放日之类的活动？	qa_others
问答种植区用户该当何论溜问答社区办公室，是否有开放日之类的活动？	qa_others
问答岸区用户如何参观问答社区办公室，是否有开放日之类的活动？	qa_others
问答社区用户如何参观问答社区办公室，是不是有开放日等等的活动？	qa_others
问答社区用户焉览胜问答社区办公室，是否有开放日之类的移位？	qa_others
问答楼区用户如何参观问答社区办公室，是否有开放日之类的运动？	qa_others
问答社区用户如何参观问答社区办公室，是否有开放日等等的活动？	qa_others
问答社区用户哪采风问答社区办公室，是否有开放日之类的活动？	qa_others
问答社区用户怎么样参观问答社区办公室，是否有开放日之类的挪？	qa_others
问答作业区用户哪边参观问答油区办公室，是否有开放日之类的活动？	qa_others
如何看待Selina（任家萱）离婚？	qa_others
争看待Selina（任家萱）离？	qa_others
怎么看待Selina（任家萱）离婚？	qa_others
何许看待Selina（任家萱）离婚？	qa_others
怎看待Selina（任家萱）离婚？	qa_others
如何待遇Selina（任家萱）离婚？	qa_others
如何相待Selina（任家萱）离婚？	qa_others
该当何论看待Selina（任家萱）离婚？	qa_others
什么样看待Selina（任家萱）离婚？	qa_others
如何看待Selina（任家萱）离异？	qa_others
怎么看待网上爆出的南京农业大学动物实验事件？	qa_others
怎么相待网上爆出的南京农业大学动物实验轩然大波？	qa_others
怎么相待网上暴露的南京农业大学植物试事件？	qa_others
怎么看待地上爆出的南京农业大学微生物实验事件？	qa_others
怎么看待网上爆出的南京农业大学微生物实验事件？	qa_others
怎么看待网上爆出的南京农业大学动物实验事变？	qa_others
怎么看待网上纸包不住火的南京农业大学植物实验事件？	qa_others
怎么待遇网上露馅儿的南京农业大学动物实验事件？	qa_others
怎么看待墙上露的南京农业大学动物实验事件？	qa_others
怎相待网上爆出的南京农业大学微生物实验事件？	qa_others
为什么会有女人只因为怀有两个月的身孕就可以一而再再而三的原谅男人出轨？	qa_others
胡会有家只因为怀有两个月的身孕就堪一而再再而三的原谅男人出轨？	qa_others
为什么会有家里只因为怀有两个月的身孕就堪一而再再而三的优容男人沉船？	qa_others
缘何会有女人只因为怀有两个月的身孕就可以一而再再而三的原谅男人出轨？	qa_others
为什么会有女人只因为怀有两个月的身孕就可以一而再再而三的谅解男人出轨？	qa_others
何故会有女人只因为怀有两个月的身孕就可以一而再再而三的原谅男人出轨？	qa_others
为什么会有女人只因兼有两个月的身孕就可以一而再再而三的海涵人夫出轨？	qa_others
为何会有夫人只因为怀有两个月的身孕就可以一而再再而三的原谅男人出轨？	qa_others
为什么会有女人只因为抱有两个月的身孕就可以一而再再而三的原谅当家的出轨？	qa_others
为什么会有妻室只因为怀有两个月的身孕就可以一而再再而三的见谅男人出轨？	qa_others
老干妈、小肥羊火锅底料这些东西能放旅行箱里带过海关吗？	qa_others
老干妈、小肥羊火锅底料那些东西能放旅行箱里带过海关吗？	qa_others
老干妈、小肥羊火锅底料这些事物能放旅行箱里带过海关吗？	qa_others
老干妈、小肥羊火锅底料该署东西能放旅行箱内胎过海关吗？	qa_others
老干妈、小肥羊火锅底料这些东西能放旅行箱内胎过海关吗？	qa_others
老干妈、小肥羊火锅底料这些物能放旅行箱里带过海关吗？	qa_others
老干妈、小肥羊火锅底料那幅东西能放旅行箱里带过海关吗？	qa_others
老干妈、小肥羊火锅底料这些事物能放旅行箱内胎过海关吗？	qa_others
老干妈、小肥羊火锅底料该署物能放旅行箱内胎过海关吗？	qa_others
老干妈、小肥羊一品锅底料这些东西能放旅行箱里带过海关吗？	qa_others
准备复读，暑假应该怎么复习？	qa_others
准备复读，暑假应该怎生复课？	qa_others
备灾复读，公休应有庸温书？	qa_others
预备复读，暑假应该岂复习？	qa_others
备而不用复读，厂礼拜应该怎么温书？	qa_others
未雨绸缪复读，暑假应该怎么复习？	qa_others
准备重读，暑假应该怎么复习？	qa_others
备灾复读，暑假有道是怎么复习？	qa_others
准备复读，暑假应该怎么温习？	qa_others
以防不测复读，暑假应该怎么复习？	qa_others
有没有人跟我一样，心里忘不掉前任的？不管换了几个对象，那个人就是释怀不了？请问应该怎么解决?	qa_others
有没有人跟我一样，心里忘不掉前任的？不管换了几个对象，那个人便宽解不了？试问应该怎么解决?	qa_others
有没有人跟我一样，心髓忘不掉先驱者的？任凭换了几个目标，死去活来人哪怕释怀源源？请问该当怎么解决?	qa_others
有没有人跟我一样，心里忘不掉前任的？不论换了几个对象，那个人就是释怀不了？借光应该怎么解决?	qa_others
有没有人跟我一样，心里忘不掉先行者的？不管换了几个对象，那个人就是释怀不了？请问应该怎么解决?	qa_others
有没有人跟我一样，心里忘不掉前任的？不管换了几个对象，那个人就是释怀不了？借光应该怎么解决?	qa_others
有没有人跟我一律，心里忘不掉前任的？不管换了几个对象，那个人纵使释怀迭起？请问应该怎么解决?	qa_others
有没有人跟我一样，心里忘不掉前任的？无论换了几个对象，那个人就是释怀不住？试问应该怎么解决?	qa_others
有没有人跟我一样，心里忘不掉先驱的？不管换了几个对象，煞是人就是释怀不了？请问该怎么解决?	qa_others
有没有人跟我平，心里忘不掉先行者的？不管换了几个靶子，那个人就是想得开络绎不绝？借问理所应当怎么解决?	qa_others
宜家哪些产品不值得买？	qa_others
宜家怎的产品不值得买？	qa_others
宜家哪些活不值得买？	qa_others
宜家哪些必要产品不值得买？	qa_others
宜家怎样产品不值得买？	qa_others
宜家怎么成品不值得买？	qa_others
宜家怎活不值得买？	qa_others
宜家怎么着产品不值得买？	qa_others
宜家安制品不值得买？	qa_others
宜家该当何论产品不值得买？	qa_others
为什么朝鲜能维持统治这么久？	qa_others
为什么荷兰能维持统治这么久？	qa_others
干吗朝鲜能维持统治这么久？	qa_others
何以朝鲜能维持当道这么久？	qa_others
为什么朝鲜能葆当权这么久？	qa_others
为什么安国能涵养统治这么久？	qa_others
为什么朝鲜能涵养统治这么久？	qa_others
怎么冰岛能维持统治这么久？	qa_others
怎么朝鲜能保全统治这么久？	qa_others
为什么朝鲜能维持秉国这么久？	qa_others
你认为《银魂》里励志或感人的对白是哪段？	qa_others
你认为《银魂》里励志或感人肺腑的对白是哪段？	qa_others
你认为《银魂》里励志或回肠荡气的定场诗是哪段？	qa_others
你看《银魂》里励志或感人的对白是哪段？	qa_others
你认为《银魂》里励志或感人的潜台词是哪段？	qa_others
你认为《银魂》里励志或荡气回肠的对白是哪段？	qa_others
你认为《银魂》里励志或感人的独白是哪段？	qa_others
你认为《银魂》里励志或感人肺腑的独白是哪段？	qa_others
你觉得《银魂》里励志或回肠荡气的对白是哪段？	qa_others
你当《银魂》里励志或顽石点头的定场诗是哪段？	qa_others
「强行污」是一种怎样的体验？	qa_others
「强行污」是一种哪些的体验？	qa_others
「强行污」是一种哪样的体验？	qa_others
「狂暴污」是一种怎样的心得？	qa_others
「强行污」是一种什么的体验？	qa_others
「粗污」是一种怎样的体会？	qa_others
「强行污」是一种该当何论的体验？	qa_others
「村野污」是一种怎样的体验？	qa_others
「强行污」是一种怎样的感受？	qa_others
「犷悍污」是一种怎样的感受？	qa_others
请问，我的婚姻很差么？老公条件和感情也很差么？	qa_others
请问，我的婚姻很差么？老公绳墨和感情也很差么？	qa_others
借光，我的婚姻很差么？老公条件和感情也很差么？	qa_others
请问，我的婚姻很差么？老公准和情义也很差么？	qa_others
请问，我的婚姻很差么？男人条件和情愫也很差么？	qa_others
借问，我的婚姻很差么？老公规则和感情也很差么？	qa_others
请问，我的亲事很差么？老公条件和感情也很差么？	qa_others
请问，我的婚姻很差么？当家的法和感情也很差么？	qa_others
试问，我的婚姻很差么？老公条件和感情也很差么？	qa_others
请问，我的婚姻很差么？老公谱和情感也很差么？	qa_others
请问名字三十四划大都活不过六十岁这种说法可靠吗？有依据吗？	qa_others
请问名字三十四划大都活然六十岁这种说法靠得住吗？有据悉吗？	qa_others
借问名字三十四划基本上活而六十岁这种说法可靠吗？有因吗？	qa_others
请问名字三十四划大都活而六十岁这种布道可靠吗？有依据吗？	qa_others
借光名字三十四划大都活然则六十岁这种说法稳操胜券吗？有依据吗？	qa_others
请问名字三十四划差不多活但六十岁这种说法保险吗？有依据吗？	qa_others
请问名字三十四划大都活然则六十岁这种说法可靠吗？有依据吗？	qa_others
请问名字三十四划大都活不过六十岁这种说法百无一失吗？有依据吗？	qa_others
请问名字三十四划大都活不过六十岁这种传教可靠吗？有依据吗？	qa_others
借问名字三十四划大都活不过六十岁这种说教可靠吗？有依据吗？	qa_others
被妈妈打屁股是一种怎样的体验？	qa_others
被妈妈打屁股是一种怎么着的体验？	qa_others
被妈妈打屁股是一种怎样的感受？	qa_others
被鸨儿打屁股是一种怎样的体验？	qa_others
被掌班打屁股是一种怎样的体验？	qa_others
被妈妈打屁股是一种怎的的体验？	qa_others
被妈妈打屁股是一种怎的感受？	qa_others
被妈妈打屁股是一种哪的体验？	qa_others
被老鸨打屁股是一种怎样的经验？	qa_others
被妈妈打屁股是一种何许的感受？	qa_others
哪种锻炼方式最能让程序员远离亚健康？	qa_others
哪种砥砺方式最能让程序员远离亚健康？	qa_others
哪种锻炼办法最能让程序员远离亚健康？	qa_others
哪种锻炼方最能让程序员远离亚健康？	qa_others
哪种千锤百炼术最能让程序员背井离乡亚健康？	qa_others
哪种淬砺点子最能让程序员离乡背井亚健康？	qa_others
哪种锻锤方式最能让程序员远离亚健康？	qa_others
哪种锻炼法最能让程序员离乡背井亚健康？	qa_others
哪种锻炼方式最能让程序员离乡背井亚健康？	qa_others
哪种锻炼方式最能让程序员离乡亚健康？	qa_others
颧骨内推是怎样一种手术？	qa_others
颧骨内推是怎样一种搭桥术？	qa_others
颧骨内推是怎么样一种手术？	qa_others
眉棱骨内推是何如一种手术？	qa_others
颧骨内推是怎样一种截肢？	qa_others
颧骨内推是安一种手术？	qa_others
颧骨内推是咋样一种手术？	qa_others
颧骨内推是怎样一种结扎？	qa_others
颧骨内推是怎样一种切诊？	qa_others
颧骨内推是怎样一种解剖？	qa_others
彭德怀和麦克阿瑟，谁的军事统帅水平更高？	qa_others
周恩来和麦克阿瑟，谁的军事统帅水平更高？	qa_others
彭德怀和麦克阿瑟，谁的枪杆子麾下水平更高？	qa_others
彭德怀和麦克阿瑟，谁的枪杆子统帅水平更高？	qa_others
彭德怀和麦克阿瑟，谁的武装部队统帅水平更高？	qa_others
彭德怀和麦克阿瑟，谁的枪杆统帅水平更高？	qa_others
彭德怀和麦克阿瑟，谁的旅统帅水平更高？	qa_others
彭德怀和麦克阿瑟，谁的队伍统帅水平更高？	qa_others
李瑞环和麦克阿瑟，谁的军事统帅水平更高？	qa_others
彭德怀和麦克阿瑟，谁的人马统帅水平更高？	qa_others
交往四年的男朋友，经常莫名其妙地打我，怎么办？	qa_others
交往四年的男朋友，频仍非驴非马地打我，怎么办？	qa_others
交往四年的男友，经常莫名其妙地打我，怎么办？	qa_others
交往四年的男朋友，经常不三不四地打我，怎么办？	qa_others
一来二去四年的男朋友，经常不三不四地打我，怎么办？	qa_others
一来二去四年的男朋友，经常非驴非马地打我，怎么办？	qa_others
过从四年的男朋友，经常不伦不类地打我，怎么办？	qa_others
交往四年的情郎，经常莫名其妙地打我，怎么办？	qa_others
明来暗往四年的男朋友，经常莫名其妙地打我，怎么办？	qa_others
交往四年的欢，经常非驴非马地打我，怎么办？	qa_others
丈母娘很作，常在老婆面前说我不好，影响夫妻感情，怎么处理？	qa_others
丈母娘很作，常在老婆面前说我不得了，影响夫妻感情，庸处理？	qa_others
丈母娘很作，常在老婆面前说我坏，影响夫妻感情，怎么处理？	qa_others
丈母娘很作，常在老婆面前说我不好，影响夫妻感情，怎么甩卖？	qa_others
丈母娘很作，常在内助前方说我糟糕，影响夫妻感情，怎处理？	qa_others
丈母很作，常在女人面前说我不好，影响夫妻感情，怎么处理？	qa_others
丈母娘很作，常在家里面前说我不好，影响夫妻感情，怎么处理？	qa_others
丈母娘很作，常在妻室前方说我不好，影响夫妻感情，怎么处理？	qa_others
丈母娘很作，常在老婆头里说我不好，影响夫妻感情，怎么处理？	qa_others
丈母娘很作，常在老婆面前说我不好，熏陶夫妻感情，怎么处理？	qa_others
被篡改的历史教科书在日本的普及率大概是多少？	qa_others
被篡改的史教科书在日本的租售率大概是聊？	qa_others
被歪曲的历史教科书在日本的普及率大概是多少？	qa_others
被篡改的历史教本在日本的入学率大概是多少？	qa_others
被篡改的历史讲义在日本的普及率大概是多少？	qa_others
被篡改的历史教科书在日本的负债率大概是多少？	qa_others
被篡改的历史教科书在日本的普及率光景是略微？	qa_others
被篡改的历史教科书在日本的抽样合格率大概是多少？	qa_others
被篡改的历史教科书在日本的生长率大概是多少？	qa_others
被篡改的历史教科书在日本的优秀率大体上是多少？	qa_others
如何看待党报的评论「中国已不可能落入拉美式『中等收入陷阱』」？	qa_others
如何相待小报的评论「中国已不可能沁入拉美式『中等收入牢笼』」？	qa_others
如何看待党报的评论「中国已不可能映入拉美式『中等入账陷阱』」？	qa_others
如何看待导报的评论「华已不也许落入拉美式『中等入账牢笼』」？	qa_others
哪样看待党报的评论「礼仪之邦已不恐入院拉美式『中等收入陷阱』」？	qa_others
争看待党报的品头论足「中国已不可能无孔不入非洲式『中等收入陷阱』」？	qa_others
如何看待党报的评论「九州已不可能落入欧洲式『中高档二档进款陷阱』」？	qa_others
咋样看待党报的讲评「中国已不可能涌入拉美式『中等收入陷阱』」？	qa_others
如何看待新闻公报的评论「中国已不可能落入拉美式『中等收入陷阱』」？	qa_others
如何看待党报的讲评「中国已不或许落入拉美式『中等低收入陷阱』」？	qa_others
肾结石有什么症状？	qa_others
分子病有什么症候？	qa_others
羞明有什么病症？	qa_others
肾结石有哎哟症状？	qa_others
肾结石有哎呀症状？	qa_others
心脑血管病有什么症状？	qa_others
肾结石有什么病象？	qa_others
肾结石有什么症候？	qa_others
猩红热有嗬哟病症？	qa_others
肾结石有嘿症状？	qa_others
为什么我无法分辨男生是否帅？	qa_others
为什么我无法辨认考生是否帅？	qa_others
缘何我一筹莫展分辨男生是否帅？	qa_others
为何我无力回天辨识男生是否帅？	qa_others
缘何我无法分辨男生是否帅？	qa_others
为什么我没辙辨老生是否帅？	qa_others
缘何我无法分辨女生是否帅？	qa_others
胡我束手无策分辨男生是否帅？	qa_others
干吗我无法辨认男生是否帅？	qa_others
何故我无法分辨男生是否帅？	qa_others
如何评价papi酱的长相？古典美女貌似不是，办公室女郎貌似不是	qa_others
哪边品头论足papi酱的长相？古典姝貌似不是，办公室女郎貌似不是	qa_others
如何评价papi酱的长相？古典美女貌似讹误，办公室女郎类同不是	qa_others
如何评介papi酱的长相？古典美女貌似不是，办公室女郎貌似不是	qa_others
如何评价papi酱的长相？典美女貌似不是，办公女郎貌似不是	qa_others
怎么评价papi酱的长相？古典美女貌似偏向，办公室女郎相像谬	qa_others
什么样评价papi酱的长相？古典美女貌似不是，办公室农妇貌似不是	qa_others
如何评价papi酱的长相？古典美女一般谬，办公室女郎貌似偏差	qa_others
该当何论评价papi酱的姿容？古典美女貌似不是，办公室女郎貌似鲁鱼亥豕	qa_others
如何评说papi酱的脸相？古典蛾眉貌似鲁鱼亥豕，办公室巾帼貌似不是	qa_others
做客孩子临走时带走几只玩具，我的孩子抗拒并一直哭，要怎么开导？	qa_others
做客孩子临走时带走几只玩具我的孩子抗拒一直哭，要怎么开导	qa_others
做客孩子临走时带走几只玩具，孩子抗拒并一直哭，怎么开导	qa_others
做客孩子临走时带走几只玩具，我孩子抗拒并一直哭怎么开导	qa_others
做客孩子临走时带走几只玩具，我的孩子抗拒一直哭怎么开导	qa_others
做客孩子临走时带走几只玩具，我孩子抗拒一直，怎么开导	qa_others
做客孩子临走时带走几只玩具我的孩子抗拒并一直，要怎么开导	qa_others
做客孩子临走时带走几只玩具我的孩子抗拒并一直哭，要怎么开导	qa_others
做客孩子临走时带走几只玩具，我的孩子抗拒并一直哭，要怎么开导	qa_others
做客孩子临走时带走几只玩具的孩子抗拒并一直，要怎么开导	qa_others
在四大做税务的工作体验如何？	qa_others
在四大做税务的工作体验如何	qa_others
在四大做税务工作体验如何	qa_others
四大做税务的工作体验如何	qa_others
在四大税务的工作体验如何	qa_others
在四大税务工作体验如何	qa_others
四大税务工作体验如何	qa_others
四大做税务工作体验如何	qa_others
四大税务的工作体验如何	qa_others
什么时候你觉得作为一名军人很自豪很值得？	qa_others
什么时候你觉得作为一名军人很自豪值得	qa_others
什么时候觉得作为一名军人自豪很值得	qa_others
什么时候觉得作为一名军人很自豪很值得	qa_others
什么时候觉得作为一名军人很自豪值得	qa_others
什么时候你觉得作为一名军人自豪值得	qa_others
什么时候你觉得作为一名军人自豪很值得	qa_others
什么时候你觉得作为一名军人很自豪很值得	qa_others
什么时候觉得作为一名军人自豪值得	qa_others
如何把校园爱情坚持下去？男生可能在毕业的很长一段时间内都是一无所有的，怎么办呢？该怎样对女生好呢？	qa_others
如何校园爱情坚持下去？男生可能毕业的很长一段时间内都一无所有，怎么办？怎样对女生好呢	qa_others
如何把校园爱情坚持下去？男生可能在毕业的很长一段时间内都是一无所有怎么办呢该怎样对女生好呢	qa_others
如何把校园爱情坚持下去男生可能在毕业的很长一段时间内都是一无所有的怎么办呢？该怎样对女生好呢	qa_others
如何把校园爱情坚持下去？男生可能在毕业很长一段时间是一无所有的，怎么办呢？该怎样对女生好呢	qa_others
如何把校园爱情坚持下去？男生可能毕业的很长一段时间内都一无所有的，怎么办呢？该怎样对女生好呢	qa_others
如何把校园爱情坚持下去？男生可能在毕业的很长一段时间内都是一无所有的，怎么办呢？该怎样对女生好呢	qa_others
如何校园爱情坚持下去？男生可能在毕业的很长一段时间都是一无所有的怎么办呢？该怎样对女生好	qa_others
如何把校园爱情坚持下去？男生可能在毕业的很长一段时间内都一无所有，怎么办该怎样对女生好呢	qa_others
如何把校园爱情坚持下去男生可能在毕业的很长一段时间内是一无所有，怎么办？该怎样对女生呢	qa_others
如何评价电视剧《雍正王朝》？	qa_others
如何评价电视剧《雍正王朝》	qa_others
如何评价电视剧雍正王朝》	qa_others
如何评价电视剧《雍正王朝	qa_others
如何评价电视剧雍正王朝	qa_others
为什么美漫里的超级英雄大都性生活混乱？	qa_others
为什么美漫里的超级英雄大都性生活混乱	qa_others
为什么美漫里超级英雄大都性生活混乱	qa_others
部分刘诗雯粉丝为什么一直对丁宁有很大的负面评论？	qa_others
部分刘诗雯粉丝为什么一直对丁宁有很大的负面评论	qa_others
部分刘诗雯粉丝为什么一直对丁宁很大负面评论	qa_others
部分刘诗雯粉丝为什么一直丁宁有很大的负面评论	qa_others
部分刘诗雯粉丝为什么一直丁宁很大的负面评论	qa_others
部分刘诗雯粉丝为什么一直丁宁很大负面评论	qa_others
部分刘诗雯粉丝为什么一直对丁宁有很大负面评论	qa_others
部分刘诗雯粉丝为什么一直丁宁有很大负面评论	qa_others
部分刘诗雯粉丝为什么一直对丁宁很大的负面评论	qa_others
你还记得自己认识的第一个“声优”吗？	qa_others
还记得自己认识的第一个“声优”吗	qa_others
还记得自己认识第一个“声优	qa_others
你还记得自己认识的第一个“声优吗	qa_others
你还记得自己认识第一个“声优”吗	qa_others
你还记得自己认识的第一个“声优”	qa_others
记得自己认识第一个“声优”吗	qa_others
你记得自己认识第一个“声优”吗	qa_others
记得自己认识的第一个“声优	qa_others
你记得自己认识第一个“声优”	qa_others
养很多花是什么体验？	qa_others
很多花是什么体验	qa_others
养很多花是什么体验	qa_others
怎样对喜欢的女生好，才让她感觉无压力？	qa_others
怎样对喜欢女生好才让她感觉压力	qa_others
怎样对喜欢的女生好，才让她感觉无压力	qa_others
怎样对喜欢的女生好，才她感觉压力	qa_others
怎样对喜欢女生让她感觉压力	qa_others
怎样对喜欢的女生，才让她感觉无压力	qa_others
怎样对喜欢的女生好才让感觉无压力	qa_others
怎样对喜欢的女生好，让她感觉压力	qa_others
怎样对喜欢的女生好，才她感觉无压力	qa_others
怎样对喜欢女生好才让她感觉无压力	qa_others
怎么才能彻底抛开穆斯林的身份？	qa_others
怎么才能彻底抛开穆斯林的身份	qa_others
怎么才能彻底抛开穆斯林身份	qa_others
你手机里有什么好看的图片？	qa_others
你手机里有什么好看的图片	qa_others
你手机有什么好看的图片	qa_others
手机里有什么好看图片	qa_others
你手机里什么好看图片	qa_others
你手机有什么好看图片	qa_others
手机什么好看的图片	qa_others
你手机里有什么好看图片	qa_others
手机里什么好看图片	qa_others
你手机里什么好看的图片	qa_others
被父性侵，如何给予警示？（已不需要回答，明白了答案和与人沟通，谢谢大家的回答）?	qa_others
被父性侵如何给予警示？已需要回答，明白了答案和与沟通谢谢大家的回答）	qa_others
被父性侵，如何给予警示（已需要回答明白了答案与人沟通，谢谢大家的回答）	qa_others
父性侵如何给予警示不需要回答，明白了答案和人沟通，谢谢大家的回答）	qa_others
被父性侵，如何给予警示？不需要回答明白了答案和沟通，谢谢大家的回答）	qa_others
被父性，如何给予警示（已不需要回答，明白答案和与沟通，谢谢大家的回答）	qa_others
被父性，如何给予警示？（需要回答，明白答案与人沟通，谢谢大家的回答）	qa_others
被父性侵，如何给予警示？（已不需要回答，明白了答案和与人沟通，谢谢大家回答）	qa_others
被父性，如何给予警示？（已不需要回答，明白了答案与沟通，谢谢大家的回答）	qa_others
被父性侵，如何给予警示？（已不需要回答，明白了答案人沟通谢谢大家的回答	qa_others
有哪些值得一生推的高端眼影产品？	qa_others
哪些值得一生推的高端眼影产品	qa_others
有哪些值得一生推的高端眼影产品	qa_others
有哪些值得一生高端眼影产品	qa_others
有哪些值得一生推高端眼影产品	qa_others
哪些值得一生推高端眼影产品	qa_others
哪些值得一生的高端眼影产品	qa_others
有哪些值得一生的高端眼影产品	qa_others
哪些值得一生高端眼影产品	qa_others
和一个性欲低的女人生活在一起是什么体验？	qa_others
和一个性欲低的女人生活一起是什么体验	qa_others
一个性欲的女人生活在一起什么体验	qa_others
和一个性欲低女人生活一起什么体验	qa_others
和一个性欲低女人生活一起是什么体验	qa_others
和一个性欲女人生活一起什么体验	qa_others
一个性欲低女人生活一起什么体验	qa_others
和一个性欲的女人生活在一起是什么体验	qa_others
和一个性欲女人生活在一起是什么体验	qa_others
一个性欲的女人生活一起是什么体验	qa_others
失恋后走出来是一种怎样的感觉？	qa_others
失恋后出来是一种怎样感觉	qa_others
失恋出来是一种怎样的感觉	qa_others
失恋后走出来是一种怎样感觉	qa_others
失恋走出来一种怎样的感觉	qa_others
失恋后出来一种怎样感觉	qa_others
失恋走出来是一种怎样的感觉	qa_others
失恋后走出来是一种怎样的感觉	qa_others
失恋后出来是一种怎样的感觉	qa_others
失恋后走出来一种怎样感觉	qa_others
如何伺候相声板块的众大V？	qa_others
如何伺候相声板块的众大V	qa_others
如何伺候相声板块的众大	qa_others
如何伺候相声板块众大	qa_others
如何伺候相声板块众大V	qa_others
有没有什么兼职利用下班后闲暇时间做一做就能达到每月三千左右收入的?	qa_others
有没有什么兼职利用下班后闲暇时间一就能达到每月三千左右收入	qa_others
有没有什么兼职利用下班后闲暇时间做一做就能达到每月三千左右收入的	qa_others
有没有什么兼职利用下班后闲暇时间做做能达到每月三千左右收入	qa_others
有没有什么兼职利用下班闲暇时间做一做能达到每月三千左右收入	qa_others
有没有什么兼职利用下班后闲暇时间做一做就能达到每月三千左右收入	qa_others
有没有什么兼职利用下班后闲暇时间做做就能达到每月三千左右收入的	qa_others
有没有什么兼职利用下班后闲暇时间一能达到每月三千左右收入	qa_others
有没有什么兼职利用下班后闲暇时间做一做达到每月三千左右收入的	qa_others
有没有什么兼职利用下班后闲暇时间一做就能达到每月三千左右收入的	qa_others
在哪儿买信托最好？	qa_others
在哪儿买信托最好	qa_others
哪儿买信托最好	qa_others
在哪儿信托最好	qa_others
哪儿信托最好	qa_others
SNH48的赵嘉敏个人到底有什么魅力？	qa_others
SNH48的赵嘉敏个人到底什么魅力	qa_others
SNH48的赵嘉敏个人到底有什么魅力	qa_others
SNH48赵嘉敏个人到底有什么魅力	qa_others
SNH48赵嘉敏个人到底什么魅力	qa_others
如何评价《三体》获得雨果奖最佳长篇小说？	qa_others
如何评价《三体获得雨果最佳长篇小说	qa_others
如何评价《三体获得雨果奖最佳长篇小说	qa_others
如何评价三体》获得雨果奖最佳长篇小说	qa_others
如何评价《三体》获得雨果奖最佳长篇小说	qa_others
如何评价三体》获得雨果最佳长篇小说	qa_others
如何评价《三体》获得雨果最佳长篇小说	qa_others
如何评价三体获得雨果奖最佳长篇小说	qa_others
如何评价三体获得雨果最佳长篇小说	qa_others
「轻松筹」捐钱可信吗？	qa_others
「轻松筹」捐钱可信	qa_others
轻松筹」捐钱可信	qa_others
「轻松筹捐钱可信吗	qa_others
「轻松捐钱可信	qa_others
「轻松筹」捐钱可信吗	qa_others
「轻松」捐钱可信吗	qa_others
轻松捐钱可信	qa_others
轻松筹」捐钱可信吗	qa_others
轻松」捐钱可信吗	qa_others
一个人住，晚上吃什么？	qa_others
一个人住，晚上什么	qa_others
一个人住，晚上吃什么	qa_others
一个人住晚上什么	qa_others
一个人住晚上吃什么	qa_others
如何看待腾讯今日话题《占道暴走团不应为被撞负全责》？	qa_others
如何看待腾讯今日话题《占暴走团不应为被撞负全责》	qa_others
如何看待腾讯今日话题《占道暴走不应为被撞全责	qa_others
如何看待腾讯今日话题《占道暴走团不应为被全责	qa_others
如何看待腾讯今日话题占道暴走不应为撞负全责》	qa_others
如何看待腾讯今日话题《占道暴走团不应为被撞负全责	qa_others
如何看待腾讯今日话题道暴走团不应为被负全责	qa_others
如何看待腾讯今日话题《占道暴走团应为被撞负全责	qa_others
如何看待腾讯今日话题《暴走团不应为撞全责》	qa_others
如何看待腾讯今日话题《占暴走团不应为撞负全责》	qa_others
养小鹿犬或者吉娃娃是什么样的体验呢？	qa_others
养小鹿犬或者吉娃娃什么样的体验呢	qa_others
小鹿犬或者吉娃娃是什么样的体验呢	qa_others
小鹿或者吉娃娃是什么样体验呢	qa_others
小鹿犬或者吉娃娃是什么样体验	qa_others
养小鹿或者吉娃娃什么样的体验	qa_others
小鹿犬或者吉娃娃是什么样的体验	qa_others
小鹿犬或者吉娃娃是什么样体验呢	qa_others
养小鹿犬或者吉娃娃是什么样体验	qa_others
养小鹿犬或者吉娃娃是什么样体验呢	qa_others
新生儿由母乳和配方奶喂养，需要额外补充DHA吗？如需要，是鱼油好还是藻油好？哪个牌子的安全些？	qa_others
新生儿由母乳配方喂养，需要额外补充DHA？如需要，是鱼油还是藻油好哪个牌子的安全些	qa_others
新生儿由母乳配方喂养，需要额外补充DHA？如需要，是鱼油好还是藻油好？哪个牌子安全些	qa_others
新生儿由母乳和配方奶喂养，需要额外补充DHA需要是鱼油好还是藻油好哪个牌子的安全些	qa_others
新生儿母乳和配方喂养，需要额外补充DHA？如需要，鱼油好还是藻油好哪个牌子的安全些	qa_others
新生儿由母乳和配方奶喂养，需要额外补充DHA吗？如需要，是鱼油好还是藻油？哪个牌子的安全些	qa_others
新生儿由母乳和配方奶喂养，需要额外补充DHA吗如需要，是鱼油好还是藻油好？哪个牌子安全些	qa_others
新生儿由母乳和配方奶喂养，需要额外补充DHA？如需要，是鱼油还是藻油好？哪个牌子的安全些	qa_others
新生儿由母乳配方喂养，需要额外补充DHA吗？如需要，是鱼油好还是藻油好？哪个牌子的安全些	qa_others
新生儿由母乳和配方奶喂养需要额外补充DHA吗需要鱼油还是藻油好？哪个牌子安全些	qa_others
有什么样特征或特质的男生你不会和他谈恋爱？（前提是你喜欢他）？	qa_others
有什么样特征或特质男生不会和谈恋爱（前提你喜欢他	qa_others
有什么样特征或特质的男生你不会和谈恋爱？（前提是喜欢他）	qa_others
有什么样特征或特质的男生你不会和他谈恋爱？前提你喜欢	qa_others
有什么样特征特质男生你不会和他谈恋爱？（前提你喜欢）	qa_others
有什么样特征或特质的男生你不会和他谈恋爱（前提是喜欢他）	qa_others
什么样特征或特质男生不会和谈恋爱？（前提你喜欢他）	qa_others
什么样特征特质男生你不会谈恋爱？前提是你喜欢他）	qa_others
什么样特征或特质男生你不会谈恋爱？前提是你喜欢他）	qa_others
什么样特征特质的男生你不会和他谈恋爱前提是你喜欢他	qa_others
如何评价“萌码”这个网站？	qa_others
如何评价萌码”这个网站	qa_others
如何评价“萌码”这个网站	qa_others
如何评价“萌码这个网站	qa_others
如何评价萌码这个网站	qa_others
如何看待武汉的大暴雨造成如此后果？	qa_others
如何看待武汉大暴雨造成如此后果	qa_others
如何看待武汉的大暴雨造成如此后果	qa_others
如何接吻男票会硬？	qa_others
如何接吻男票硬	qa_others
如何接吻男票会硬	qa_others
如何接吻男票	qa_others
如何接吻男票会	qa_others
为什么说长征是「伟大的」？	qa_others
为什么说长征是「伟大	qa_others
为什么说长征伟大的	qa_others
为什么说长征是伟大」	qa_others
为什么说长征伟大」	qa_others
为什么说长征伟大的」	qa_others
为什么说长征是伟大的」	qa_others
为什么说长征是「伟大的」	qa_others
为什么说长征「伟大」	qa_others
为什么长征是伟大	qa_others
剩下59天高考如何提高数学？	qa_others
剩下59天高考如何提高数学	qa_others
有哪些10元以下的实用文艺小物件？	qa_others
有哪些10元以下的实用文艺小物件	qa_others
哪些10元以下的实用文艺小物件	qa_others
有哪些10元以下实用文艺小物件	qa_others
有哪些10元以下的实用文艺物件	qa_others
哪些10元以下的实用文艺物件	qa_others
哪些10元以下实用文艺小物件	qa_others
有哪些10元以下实用文艺物件	qa_others
哪些10元以下实用文艺物件	qa_others
金庸小说里最萌的人物是谁？	qa_others
金庸小说里最萌的人物是谁	qa_others
金庸小说里最萌人物是	qa_others
金庸小说里最萌的人物谁	qa_others
金庸小说最萌的人物谁	qa_others
金庸小说里最萌的人物	qa_others
金庸小说最萌的人物是谁	qa_others
金庸小说里最萌人物谁	qa_others
金庸小说最萌的人物是	qa_others
金庸小说里最萌的人物是	qa_others
考研结束，你有什么想说的？	qa_others
考研结束你什么想说的	qa_others
考研结束，你有什么想	qa_others
考研结束，你有什么想的	qa_others
考研结束你有什么想	qa_others
考研结束有什么想说	qa_others
考研结束你有什么想说的	qa_others
考研结束，你什么想	qa_others
考研结束，你有什么说的	qa_others
考研结束，有什么说的	qa_others
如何理解马尔克斯《苦妓回忆录》？	qa_others
如何理解马尔克斯《苦妓回忆录》	qa_others
如何理解马尔克斯《苦妓回忆录	qa_others
如何理解马尔克斯苦妓回忆录》	qa_others
如何理解马尔克斯苦妓回忆录	qa_others
留学生代购风险那么大为什么不去打工？	qa_others
留学生代购风险那么为什么不去打工	qa_others
留学生代购风险那么大为什么不去打工	qa_others
如何看待【饿了么社论】:但愿你心有所持，温和坚定？	qa_others
如何看待【饿了么社论】:但愿你心有所持，温和坚定	qa_others
如何看待【么社论:但愿你心有所持温和坚定	qa_others
如何看待饿么社论】:但愿你心有所持，温和坚定	qa_others
如何看待【饿了社论:但愿你心有所持温和坚定	qa_others
如何看待么社论】:但愿你心有所持，温和坚定	qa_others
如何看待饿了社论】但愿你心有所持，温和坚定	qa_others
如何看待饿么社论】但愿你心有所，温和坚定	qa_others
如何看待【饿了么社论:但愿你心有所持，温和坚定	qa_others
如何看待了么社论】但愿你心有所持，温和坚定	qa_others
国外色情行业管理体系和产业链是怎样的？	qa_others
国外色情行业管理体系和产业链怎样	qa_others
国外色情行业管理体系和产业链是怎样	qa_others
国外色情行业管理体系和产业链是怎样的	qa_others
国外色情行业管理体系产业链是怎样的	qa_others
国外色情行业管理体系和产业链怎样的	qa_others
国外色情行业管理体系产业链怎样	qa_others
国外色情行业管理体系产业链怎样的	qa_others
国外色情行业管理体系产业链是怎样	qa_others
你最后悔买的小米产品是哪一个？	qa_others
你最后悔买小米产品是哪一个	qa_others
你最后悔的小米产品是一个	qa_others
你最后悔买小米产品哪一个	qa_others
你后悔的小米产品是一个	qa_others
你后悔买的小米产品是哪一个	qa_others
你最后悔的小米产品一个	qa_others
你最后悔买的小米产品一个	qa_others
最后悔买小米产品是哪一个	qa_others
你最后悔买的小米产品哪一个	qa_others
现实中车真的可以爬上45°坡吗？	qa_others
现实中车真的可以爬上45°吗	qa_others
现实中车真的可以上45°坡	qa_others
现实中车真的可以爬上45°	qa_others
现实中车真的可以上45°吗	qa_others
现实中车真的可以爬上45°坡	qa_others
现实中车真的可以爬上45°坡吗	qa_others
现实中车真的可以上45°	qa_others
现实中车真的可以上45°坡吗	qa_others
如何评价老罗的锤子科技对OpenSSL基金会捐款100万元这件事？	qa_others
如何评价老罗的锤子科技对OpenSSL基金会捐款100万元这件事	qa_others
如何评价老罗的锤子科技OpenSSL基金会捐款100万元这件事	qa_others
如何评价老罗的锤子科技OpenSSL基金会捐款100万元这件	qa_others
如何评价老罗锤子科技OpenSSL基金会捐款100万元这件事	qa_others
如何评价老罗锤子科技对OpenSSL基金会捐款100万元这件事	qa_others
如何评价老罗锤子科技OpenSSL基金会捐款100万元这件	qa_others
如何评价老罗的锤子科技对OpenSSL基金会捐款100万元这件	qa_others
如何评价老罗锤子科技对OpenSSL基金会捐款100万元这件	qa_others
中国女生是否不如日本、韩国女生优秀？	qa_others
中国女生是否不如日本、韩国女生优秀	qa_others
中国女生是否不如日本韩国女生优秀	qa_others
你们见过最抠门的老板什么样子？	qa_others
你们见过最抠门的老板什么样子	qa_others
你们见过最抠门老板什么样子	qa_others
你们见过抠门的老板什么样子	qa_others
你们见最抠门的老板什么样子	qa_others
你们过最抠门的老板什么样子	qa_others
你们过最抠门老板什么样子	qa_others
你们最抠门的老板什么样子	qa_others
你们抠门的老板什么样子	qa_others
你们最抠门老板什么样子	qa_others
如何评价10月日剧Chef～三星校餐？	qa_others
如何评价10月日剧Chef～三星校餐	qa_others
如何评价10月日剧Chef三星校餐	qa_others
如何评价语c？blc真的会对青少年成长产生负面影响吗？	qa_others
如何评价语？blc真的会对青少年成长产生负面影响	qa_others
如何评价语c？blc真的会对青少年成长产生负面影响吗	qa_others
如何评价语blc真的会对青少年成长产生负面影响	qa_others
如何评价语？blc真的会青少年成长产生负面影响吗	qa_others
如何评价语c？blc真的会对青少年成长产生负面影响	qa_others
如何评价cblc真的会对青少年成长产生负面影响吗	qa_others
如何评价？blc真的会对青少年成长产生负面影响	qa_others
如何评价blc真的会对青少年成长产生负面影响吗	qa_others
如何评价语cblc真的会对青少年成长产生负面影响	qa_others
大二迷茫学生对考研和人生的困惑?	qa_others
大二迷茫学生对考研和人生的困惑	qa_others
大二迷茫学生对考研人生的困惑	qa_others
大二迷茫学生考研和人生的困惑	qa_others
大二迷茫学生对考研和人生困惑	qa_others
大二迷茫学生考研人生困惑	qa_others
大二迷茫学生考研人生的困惑	qa_others
大二迷茫学生对考研人生困惑	qa_others
大二迷茫学生考研和人生困惑	qa_others
高考复读会遇到哪些困难？我的复读理由充不充足？	qa_others
高考复读会遇到哪些困难？的复读理由充不充足	qa_others
高考复读会遇到哪些困难复读理由充不充足	qa_others
高考复读会遇到哪些困难我的复读理由充不充足	qa_others
高考复读会遇到哪些困难？我的复读理由充不充足	qa_others
高考复读遇到哪些困难？的复读理由充不充足	qa_others
高考复读遇到哪些困难？我的复读理由充不充足	qa_others
高考复读遇到哪些困难我的复读理由充不充足	qa_others
高考复读会遇到哪些困难？我复读理由充不充足	qa_others
高考复读会遇到哪些困难我复读理由充不充足	qa_others
闭关锁国的日本，为什么会一眨眼，成了对外侵伐的罪恶之国？	qa_others
闭关锁国日本，为什么一眨眼对外侵伐的罪恶	qa_others
闭关锁国日本，为什么会一眨眼，成了对外侵伐的罪恶之	qa_others
闭关锁国日本，为什么会一眨眼成了对外侵伐的罪恶之国	qa_others
闭关锁国的日本，为什么会一眨眼，成了对外侵伐的罪恶之	qa_others
闭关锁国的日本，为什么一眨眼了对外侵伐的罪恶之国	qa_others
闭关锁国的日本为什么会一眨眼，成了对外侵伐罪恶之国	qa_others
闭关锁国日本，为什么会一眨眼，成了对外侵伐的罪恶国	qa_others
闭关锁国日本，为什么一眨眼，了对外侵伐的罪恶之国	qa_others
闭关锁国的日本，为什么会一眨眼，了对外侵伐的罪恶国	qa_others
你最性感而又不失保守的照片是哪张？	qa_others
你性感又不失保守的照片哪张	qa_others
你最性感而又不失保守的照片是哪张	qa_others
最性感不失保守照片是哪张	qa_others
你性感而又不失保守的照片是哪张	qa_others
你最性感而不失保守的照片是哪张	qa_others
最性感不失保守的照片是哪张	qa_others
你最性感而又不失保守的照片哪张	qa_others
你最性感而不失保守的照片哪张	qa_others
你性感而又不失保守的照片哪张	qa_others
二本学校就不是学校了吗？	qa_others
二本学校就不是学校了吗	qa_others
二本学校就不是学校了	qa_others
二本学校就不是学校吗	qa_others
二本学校不是学校了吗	qa_others
二本学校就不是学校	qa_others
二本学校不是学校了	qa_others
二本学校不是学校吗	qa_others
韩国化妆品到底怎么样呢？	qa_others
韩国化妆品到底怎么样呢	qa_others
韩国化妆品到底怎么样	qa_others
男同性恋真的分「攻」、「受」吗？	qa_others
男同性恋真的攻受」吗	qa_others
男同性恋真的分、「受」	qa_others
男同性恋真的攻」、「」吗	qa_others
男同性恋真的分「、「受」吗	qa_others
男同性恋真的分「攻」、受	qa_others
男同性恋真的分「攻」、「受」	qa_others
男同性恋真的分「攻」、受」吗	qa_others
男同性恋真的分「」、「受」吗	qa_others
男同性恋真的攻」、「」	qa_others
大学生最可行的自费摩托车旅行方案是？	qa_others
大学生最可行的自费摩托车旅行方案	qa_others
大学生最可行自费摩托车旅行方案是	qa_others
大学生最可行的自费摩托车旅行方案是	qa_others
大学生可行自费摩托车旅行方案是	qa_others
大学生可行的自费摩托车旅行方案是	qa_others
大学生可行的自费摩托车旅行方案	qa_others
大学生可行自费摩托车旅行方案	qa_others
大学生最可行自费摩托车旅行方案	qa_others
合肥有哪些不错的IT公司？	qa_others
合肥有哪些不错的IT公司	qa_others
合肥哪些不错的IT公司	qa_others
合肥有哪些不错IT公司	qa_others
合肥哪些不错IT公司	qa_others
电子商务的现状?	qa_others
电子商务的现状	qa_others
电子商务现状	qa_others
有哪些好看的明清小说？	qa_others
哪些好看明清小说	qa_others
有哪些好看明清小说	qa_others
有哪些好看的明清小说	qa_others
哪些好看的明清小说	qa_others
做爱时女人在想什么？	qa_others
做爱时女人在想什么	qa_others
做爱时女人想什么	qa_others
做爱时女人在什么	qa_others
做爱时女人什么	qa_others
中国股市这一轮暴跌导致了中产阶级和平民怎么样的损失？	qa_others
中国股市一轮暴跌导致中产阶级和平民怎么样损失	qa_others
中国股市这一轮暴跌导致了中产阶级和平民怎么样损失	qa_others
中国股市这一轮暴跌导致了中产阶级平民怎么样的损失	qa_others
中国股市这一轮暴跌导致中产阶级和平民怎么样损失	qa_others
中国股市这一轮暴跌导致了中产阶级和平民怎么样的损失	qa_others
中国股市一轮暴跌导致了中产阶级和平民怎么样损失	qa_others
中国股市一轮暴跌导致中产阶级和平民怎么样的损失	qa_others
中国股市一轮暴跌导致了中产阶级和平民怎么样的损失	qa_others
中国股市一轮暴跌导致了中产阶级平民怎么样的损失	qa_others
技术移民加拿大有什么条件？	qa_others
技术移民加拿大什么条件	qa_others
技术移民加拿大有什么条件	qa_others
《南方周末》这四个字对你意味着什么？	qa_others
《南方周末》四个字对你意味着什么	qa_others
《南方周末》这四个对意味着什么	qa_others
《南方周末这四个字对意味着什么	qa_others
南方周末》这四个字对你意味着什么	qa_others
《南方周末》这四个字对你意味着什么	qa_others
《南方周末》四个字你意味着什么	qa_others
《南方周末四个字对你意味着什么	qa_others
《南方周末》这四个对你意味着什么	qa_others
《南方周末》四个意味着什么	qa_others
白银连环杀人案犯高承勇是个什么样的人？怎样分析他的心理？	qa_others
白银连环杀人案犯高承勇是什么样的？怎样分析他的心理	qa_others
白银连环杀人案犯高承勇是个什么样的？怎样分析他的心理	qa_others
白银连环杀人案犯高承勇个什么样的？怎样分析他的心理	qa_others
白银连环杀人案犯高承勇是什么样人？怎样分析心理	qa_others
白银连环杀人案犯高承勇是个什么样的人怎样分析他的心理	qa_others
白银连环杀人案犯高承勇是个什么样的？怎样分析的心理	qa_others
白银连环杀人案犯高承勇什么样人？怎样分析他的心理	qa_others
白银连环杀人案犯高承勇是个什么样的人怎样分析心理	qa_others
白银连环杀人案犯高承勇是个什么样的人怎样分析的心理	qa_others
有哪些适合家长学习的儿童教育书籍？	qa_others
哪些适合家长学习的儿童教育书籍	qa_others
有哪些适合家长学习的儿童教育书籍	qa_others
哪些适合家长学习儿童教育书籍	qa_others
有哪些适合家长学习儿童教育书籍	qa_others
中国有哪些小而美的城市？	qa_others
中国哪些小而美的城市	qa_others
中国有哪些小而美的城市	qa_others
古生物学家在缅甸琥珀市场发现了含有完整恐龙尾巴的琥珀有何重大意义？	qa_others
古生物学家在缅甸琥珀市场发现了含有完整恐龙尾巴的琥珀有何重大意义	qa_others
古生物学家缅甸琥珀市场发现了含有完整恐龙尾巴的琥珀有何重大意义	qa_others
古生物学家在缅甸琥珀市场发现了含有完整恐龙尾巴琥珀有何重大意义	qa_others
古生物学家在缅甸琥珀市场发现含有完整恐龙尾巴琥珀有何重大意义	qa_others
古生物学家缅甸琥珀市场发现了含有完整恐龙尾巴琥珀有何重大意义	qa_others
古生物学家在缅甸琥珀市场发现含有完整恐龙尾巴的琥珀有何重大意义	qa_others
古生物学家缅甸琥珀市场发现含有完整恐龙尾巴的琥珀有何重大意义	qa_others
古生物学家缅甸琥珀市场发现含有完整恐龙尾巴琥珀有何重大意义	qa_others
人权重要还是通过打土豪分田地重要？	qa_others
人权重要还是通过打土豪分田地重要	qa_others
人权重要还是通过土豪分田地重要	qa_others
人权重要还是通过土豪田地重要	qa_others
人权重要还是通过打土豪田地重要	qa_others
杂志谈到越南女性地位低，儿子吃饭后母亲才能吃是真的吗？	qa_others
杂志谈到越南女性地位儿子吃饭后母亲才能是真的吗	qa_others
杂志谈到越南女性地位，儿子吃饭后母亲才能吃真的吗	qa_others
杂志谈到越南女性地位，儿子吃饭后母亲才能是真的	qa_others
杂志谈到越南女性地位低，儿子吃饭后母亲才能吃是真的吗	qa_others
杂志谈到越南女性地位低，儿子吃饭母亲才能真的吗	qa_others
杂志谈到越南女性地位低，儿子吃饭后母亲才能吃真的吗	qa_others
杂志谈到越南女性地位低，儿子吃饭后母亲才能吃真的	qa_others
杂志谈到越南女性地位低，儿子吃饭后母亲才能吃是真的	qa_others
杂志谈到越南女性地位低儿子吃饭母亲才能真的吗	qa_others
我们新开了家早教中心，可是一直招不到合适的老师，怎么办？	qa_others
我们新开家早教中心，可是一直不到合适的老师，怎么办	qa_others
我们新开家早教中心可是一直招不到合适的老师，怎么办	qa_others
我们新开家早教中心，可是一直招不到合适的老师，怎么办	qa_others
我们新开家早教中心，可是一直不到合适的老师怎么办	qa_others
我们新开家早教中心，可是一直不到合适老师，怎么办	qa_others
我们新开了家早教中心可是一直招不到合适的老师，怎么办	qa_others
我们新开了家早教中心，可是一直不到合适老师怎么办	qa_others
我们新开了家早教中心可是一直不到合适老师，怎么办	qa_others
我们新开了家早教中心，可是一直不到合适的老师怎么办	qa_others
你听过的三观极正的一句话是？	qa_others
你听的三观极正的一句是	qa_others
你听过的三观极正一句话是	qa_others
你听的三观极正的一句话是	qa_others
过的三观极正的一句话是	qa_others
你的三观极正的一句话是	qa_others
你三观极正的一句是	qa_others
你听过的三观极正一句话	qa_others
听过的三观极正一句	qa_others
你听过的三观极正的一句话	qa_others
说话语速快的人是否更聪明？	qa_others
说话语速快的人是否更聪明	qa_others
说话语速快人是否更聪明	qa_others
说话语速人是否更聪明	qa_others
说话语速的人是否更聪明	qa_others
说话语速快的人是否聪明	qa_others
说话语速快的是否更聪明	qa_others
说话语速快是否聪明	qa_others
说话语速的是否更聪明	qa_others
说话语速的是否聪明	qa_others
自己当老板真的像看起来那么美好么？	qa_others
自己当老板真的像看起来那么美好么	qa_others
自己当老板真的看起来那么美好么	qa_others
自己当老板真的像看起来那么美好	qa_others
自己当老板真的看起来那么美好	qa_others
哪些纪录片可以称为「神作」？	qa_others
哪些纪录片可以称为「神作」	qa_others
哪些纪录片可以称为「神作	qa_others
哪些纪录片可以称为神作」	qa_others
哪些纪录片可以称为神作	qa_others
染发烫发真的会导致白血病吗？	qa_others
染发烫发真的导致白血病吗	qa_others
染发烫发真的会导致白血病吗	qa_others
染发烫发真的会导致白血病	qa_others
染发烫发真的导致白血病	qa_others
一个人的人心究竟能有多坏？	qa_others
一个人人心究竟能多坏	qa_others
一个的人心究竟能有多坏	qa_others
一个人的人心究竟多坏	qa_others
一个人心究竟能有多坏	qa_others
一个人的人心究竟有多坏	qa_others
一个的人心究竟有多坏	qa_others
一个人人心究竟多坏	qa_others
一个人的人心究竟能有多坏	qa_others
一个的人心究竟能多坏	qa_others
男朋友总是说忙，是不是不爱我了？	qa_others
男朋友总是忙，是不是不爱我了	qa_others
男朋友总是说，是不是不爱我了	qa_others
男朋友总是忙是不是不爱我了	qa_others
男朋友总是说忙，是不是不爱我了	qa_others
男朋友总是忙是不是不爱我	qa_others
男朋友总是说忙，是不是不爱	qa_others
男朋友总是忙是不是不爱	qa_others
男朋友总是说忙是不是不爱了	qa_others
男朋友总是忙，是不是不爱我	qa_others
视力正常的人如何提高视力？	qa_others
视力正常的如何提高视力	qa_others
视力正常人如何提高视力	qa_others
视力正常的人如何提高视力	qa_others
视力正常如何提高视力	qa_others
问答社区用户如何参观问答社区办公室，是否有开放日之类的活动？	qa_others
问答社区用户如何参观问答社区办公室是否有开放日之类的活动	qa_others
问答社区用户如何参观问答社区办公室是否开放日之类的活动	qa_others
问答社区用户如何参观问答社区办公室，是否有开放日之类的活动	qa_others
问答社区用户如何参观问答社区办公室是否有开放日之类活动	qa_others
问答社区用户如何参观问答社区办公室，是否开放日之类的活动	qa_others
问答社区用户如何参观问答社区办公室，是否有开放日之类活动	qa_others
问答社区用户如何参观问答社区办公室，是否开放日之类活动	qa_others
问答社区用户如何参观问答社区办公室是否开放日之类活动	qa_others
如何看待Selina（任家萱）离婚？	qa_others
如何看待Selina任家萱）离婚	qa_others
如何看待Selina（任家萱离婚	qa_others
如何看待Selina（任家萱）离婚	qa_others
如何看待Selina任家萱离婚	qa_others
怎么看待网上爆出的南京农业大学动物实验事件？	qa_others
怎么看待网上爆出的南京农业大学动物实验事件	qa_others
怎么看待网上爆出南京农业大学动物实验事件	qa_others
为什么会有女人只因为怀有两个月的身孕就可以一而再再而三的原谅男人出轨？	qa_others
为什么会有女人只因为怀有两个的身孕就可以一而再再而三原谅男人出轨	qa_others
为什么会有女人只因为怀有两个的身孕可以一而再再而三原谅男人出轨	qa_others
为什么会女人只因为怀有两个月的身孕可以一而再再而三原谅男人出轨	qa_others
为什么会有女人只因为怀有两个月的身孕就可以一而再再而三的原谅男人出轨	qa_others
为什么会有女人只因为怀有两个月身孕就可以一而再再而三的原谅男人出轨	qa_others
为什么女人因为怀有两个的身孕就可以一而再再而三的原谅男人出轨	qa_others
为什么会女人只因为怀有两个的身孕就可以一而再再而三的原谅男人出轨	qa_others
为什么有女人只因为怀有两个的身孕就可以一而再再而三的原谅男人出轨	qa_others
为什么有女人只因为怀有两个月的身孕可以一而再再而三的原谅男人出轨	qa_others
老干妈、小肥羊火锅底料这些东西能放旅行箱里带过海关吗？	qa_others
老干妈、小肥羊火锅底料这些东西能放旅行箱里带海关吗	qa_others
老干妈、小肥羊火锅底料这些东西能放旅行箱里带海关	qa_others
老干妈、小肥羊火锅底料这些东西能放旅行箱里带过海关	qa_others
老干妈、小肥羊火锅底料这些东西能放旅行箱里带过海关吗	qa_others
老干妈小肥羊火锅底料这些东西能放旅行箱里带过海关吗	qa_others
老干妈小肥羊火锅底料这些东西能放旅行箱里带海关	qa_others
老干妈小肥羊火锅底料这些东西能放旅行箱里带过海关	qa_others
老干妈小肥羊火锅底料这些东西能放旅行箱里带海关吗	qa_others
准备复读，暑假应该怎么复习？	qa_others
准备复读，暑假应该怎么复习	qa_others
准备复读暑假应该怎么复习	qa_others
有没有人跟我一样，心里忘不掉前任的？不管换了几个对象，那个人就是释怀不了？请问应该怎么解决?	qa_others
有没有跟我一样，心里忘不掉前任的？不管换了几个对象，那个就是释怀不了？请问应该怎么解决	qa_others
有没有人一样，心里忘不掉前任不管换了几个对象，那个人就是释怀不了？请问应该怎么解决	qa_others
有没有人我一样心里忘不掉前任的？不管换了几个对象那个人就是释怀不了请问应该怎么解决	qa_others
有没有我一样心里忘不掉前任的不管换了几个对象，那个人就是释怀不了？请问应该怎么解决	qa_others
有没有人跟我一样，心里忘不掉前任的？不管了几个对象，那个人就是释怀不了？请问应该怎么解决	qa_others
有没有人跟一样心里忘不掉前任？不管换了几个对象，那个人就是释怀不了？请问应该怎么解决	qa_others
有没有人跟一样，心里忘不掉前任？不管换了几个对象，那个人就是释怀不了？请问应该怎么解决	qa_others
有没有人跟我一样，心里忘不掉前任的不管了几个对象那个人就是释怀不了？请问应该怎么解决	qa_others
有没有跟我一样，心里忘不掉前任？不管了几个对象，那个就是释怀不了？请问应该怎么解决	qa_others
宜家哪些产品不值得买？	qa_others
宜家哪些产品值得买	qa_others
宜家哪些产品不值得买	qa_others
为什么朝鲜能维持统治这么久？	qa_others
为什么朝鲜维持统治这么久	qa_others
为什么朝鲜能维持统治这么久	qa_others
你认为《银魂》里励志或感人的对白是哪段？	qa_others
你认为银魂励志或感人的对白是哪段	qa_others
你认为《银魂里励志感人对白哪段	qa_others
认为《银魂》里励志或感人对白是哪段	qa_others
你认为银魂里励志或感人的对白是哪段	qa_others
认为《银魂励志或感人的对白是哪段	qa_others
你认为银魂里励志或感人的对白哪段	qa_others
你认为银魂》里励志或感人的对白哪段	qa_others
你认为《银魂》励志感人的对白是哪段	qa_others
你认为《银魂》里励志或感人的对白是哪段	qa_others
「强行污」是一种怎样的体验？	qa_others
「强行污」一种怎样体验	qa_others
「强行污是一种怎样的体验	qa_others
强行污」是一种怎样的体验	qa_others
「强行污一种怎样的体验	qa_others
强行是一种怎样的体验	qa_others
「强行」一种怎样体验	qa_others
「强行污」是一种怎样的体验	qa_others
强行污一种怎样的体验	qa_others
「强行污是一种怎样体验	qa_others
请问，我的婚姻很差么？老公条件和感情也很差么？	qa_others
请问，我的婚姻很差么老公条件和感情很	qa_others
请问，我的婚姻很差么老公条件感情也很差么	qa_others
请问，婚姻很差么？老公条件和感情也差么	qa_others
请问，婚姻很差么？老公条件和感情也很差么	qa_others
请问，我的婚姻很差？老公条件和感情也很差	qa_others
请问，我的婚姻很差？老公条件和感情也很差么	qa_others
请问我婚姻很差么？老公条件感情也很么	qa_others
请问的婚姻很差？老公条件感情也差么	qa_others
请问，我婚姻很差么？老公条件和感情也很差	qa_others
请问名字三十四划大都活不过六十岁这种说法可靠吗？有依据吗？	qa_others
请问名字三十四划大都不过六十岁这种说法可靠吗？依据吗	qa_others
请问名字三十四划大都活不过六十岁这种说法可靠吗？依据	qa_others
请问名字三十四大都活不过六十岁这种说法可靠吗？有依据吗	qa_others
请问名字三十四划大都活不过六十岁这种说法可靠吗依据	qa_others
请问名字三十四划大都活不过六十岁这种说法可靠吗？有依据吗	qa_others
请问名字三十四大都活不过六十岁这种说法可靠吗有依据吗	qa_others
请问名字三十四划大都活不过六十岁这种说法可靠？有依据	qa_others
请问名字三十四划大都活不过六十岁这种说法可靠吗？有依据	qa_others
请问名字三十四大都不过六十岁这种说法可靠有依据	qa_others
被妈妈打屁股是一种怎样的体验？	qa_others
被妈妈打屁股是一种怎样体验	qa_others
被妈妈打屁股一种怎样的体验	qa_others
被妈妈打屁股是一种怎样的体验	qa_others
妈妈打屁股一种怎样的体验	qa_others
妈妈打屁股是一种怎样体验	qa_others
妈妈打屁股是一种怎样的体验	qa_others
妈妈打屁股一种怎样体验	qa_others
被妈妈打屁股一种怎样体验	qa_others
哪种锻炼方式最能让程序员远离亚健康？	qa_others
哪种锻炼方式最能让程序员远离亚健康	qa_others
哪种锻炼方式最能程序员远离亚健康	qa_others
颧骨内推是怎样一种手术？	qa_others
颧骨内推是怎样一种手术	qa_others
颧骨推是怎样一种手术	qa_others
彭德怀和麦克阿瑟，谁的军事统帅水平更高？	qa_others
彭德怀麦克阿瑟，谁的军事统帅水平更高	qa_others
彭德怀和麦克阿瑟，的军事统帅水平更高	qa_others
彭德怀和麦克阿瑟，谁的军事统帅水平更高	qa_others
彭德怀和麦克阿瑟谁军事统帅水平更高	qa_others
彭德怀和麦克阿瑟谁的军事统帅水平更高	qa_others
彭德怀麦克阿瑟，的军事统帅水平更高	qa_others
彭德怀和麦克阿瑟军事统帅水平更高	qa_others
彭德怀和麦克阿瑟，军事统帅水平更高	qa_others
彭德怀麦克阿瑟的军事统帅水平更高	qa_others
交往四年的男朋友，经常莫名其妙地打我，怎么办？	qa_others
交往四年的男朋友，经常莫名其妙地打我，怎么办	qa_others
交往四年的男朋友，经常莫名其妙打我怎么办	qa_others
交往四年的男朋友，经常莫名其妙打，怎么办	qa_others
交往四年的男朋友，经常莫名其妙地打，怎么办	qa_others
交往四年的男朋友，经常莫名其妙地打我怎么办	qa_others
交往四年男朋友经常莫名其妙地打我怎么办	qa_others
交往四年男朋友经常莫名其妙打，怎么办	qa_others
交往四年男朋友，经常莫名其妙打我怎么办	qa_others
交往四年的男朋友经常莫名其妙地我，怎么办	qa_others
丈母娘很作，常在老婆面前说我不好，影响夫妻感情，怎么处理？	qa_others
丈母娘很作，常在老婆面前我不好影响夫妻感情怎么处理	qa_others
丈母娘很作常在老婆面前我不好影响夫妻感情，怎么处理	qa_others
丈母娘很作，常在老婆面前说我不好影响夫妻感情怎么处理	qa_others
丈母娘很作常在老婆面前不好影响夫妻感情怎么处理	qa_others
丈母娘很作，常在老婆面前我不好影响夫妻感情，怎么处理	qa_others
丈母娘很作常在老婆面前我不好，影响夫妻感情怎么处理	qa_others
丈母娘很作常在老婆面前不好影响夫妻感情，怎么处理	qa_others
丈母娘很作，常在老婆面前说我不好，影响夫妻感情怎么处理	qa_others
丈母娘很作，常在老婆面前说我不好，影响夫妻感情，怎么处理	qa_others
被篡改的历史教科书在日本的普及率大概是多少？	qa_others
被篡改的历史教科书在日本的普及率大概是多少	qa_others
被篡改历史教科书日本普及率大概多少	qa_others
被篡改的历史教科书在日本的普及率大概多少	qa_others
被篡改历史教科书在日本的普及率大概多少	qa_others
被篡改的历史教科书日本普及率大概多少	qa_others
被篡改的历史教科书在日本普及率大概是多少	qa_others
篡改历史教科书在日本的普及率大概是多少	qa_others
被篡改历史教科书在日本的普及率大概是多少	qa_others
被篡改历史教科书日本的普及率大概是多少	qa_others
如何看待党报的评论「中国已不可能落入拉美式『中等收入陷阱』」？	qa_others
如何看待党报的评论中国已不可能落入拉美中等收入陷阱』」	qa_others
如何看待党报的评论「中国已不可能落入拉美式中等收入陷阱	qa_others
如何看待党报的评论「中国已不可能落入拉美『中等收入陷阱」	qa_others
如何看待党报的评论中国已不可能落入拉美『中等收入陷阱』」	qa_others
如何看待党报的评论中国已不可能落入拉美式中等收入陷阱』	qa_others
如何看待党报的评论「中国可能落入拉美式『中等收入陷阱』	qa_others
如何看待党报评论「中国已不可能落入拉美式『中等收入陷阱』」	qa_others
如何看待党报评论「中国已不可能落入拉美式『中等收入陷阱	qa_others
如何看待党报评论「中国已不可能落入拉美『中等收入陷阱」	qa_others
肾结石有什么症状？	qa_others
肾结石什么症状	qa_others
肾结石有什么症状	qa_others
为什么我无法分辨男生是否帅？	qa_others
为什么我无法分辨男生是否帅	qa_others
为什么我无法分辨男生是否	qa_others
为什么无法分辨男生是否帅	qa_others
为什么无法分辨男生是否	qa_others
如何评价papi酱的长相？古典美女貌似不是，办公室女郎貌似不是	qa_others
如何评价papi酱的长相？古典美女貌似不是，办公室女郎貌似	qa_others
如何评价papi的长相？古典美女貌似不是，办公室女郎貌似	qa_others
如何评价papi酱长相古典美女貌似不是，办公室女郎貌似	qa_others
如何评价papi酱长相？古典美女貌似不是，办公室女郎貌似	qa_others
如何评价papi酱的长相古典美女貌似不是，办公室女郎貌似	qa_others
如何评价papi的长相古典美女貌似不是办公室女郎貌似	qa_others
如何评价papi酱的长相古典美女貌似不是办公室女郎貌似	qa_others
如何评价papi长相？古典美女貌似不是办公室女郎貌似	qa_others
如何评价papi的长相古典美女貌似不是，办公室女郎貌似	qa_others
做客孩子临走时带走几只玩具，我的孩子抗拒并一直哭，要怎么开导？	qa_others
在四大做税务的工作体验如何？	qa_others
什么时候你觉得作为一名军人很自豪很值得？	qa_others
如何把校园爱情坚持下去？男生可能在毕业的很长一段时间内都是一无所有的，怎么办呢？该怎样对女生好呢？	qa_others
如何评价电视剧《雍正王朝》？	qa_others
为什么美漫里的超级英雄大都性生活混乱？	qa_others
部分刘诗雯粉丝为什么一直对丁宁有很大的负面评论？	qa_others
你还记得自己认识的第一个“声优”吗？	qa_others
养很多花是什么体验？	qa_others
怎样对喜欢的女生好，才让她感觉无压力？	qa_others
怎么才能彻底抛开穆斯林的身份？	qa_others
你手机里有什么好看的图片？	qa_others
被父性侵，如何给予警示？（已不需要回答，明白了答案和与人沟通，谢谢大家的回答）?	qa_others
有哪些值得一生推的高端眼影产品？	qa_others
和一个性欲低的女人生活在一起是什么体验？	qa_others
失恋后走出来是一种怎样的感觉？	qa_others
如何伺候相声板块的众大V？	qa_others
有没有什么兼职利用下班后闲暇时间做一做就能达到每月三千左右收入的?	qa_others
在哪儿买信托最好？	qa_others
SNH48的赵嘉敏个人到底有什么魅力？	qa_others
如何评价《三体》获得雨果奖最佳长篇小说？	qa_others
「轻松筹」捐钱可信吗？	qa_others
一个人住，晚上吃什么？	qa_others
如何看待腾讯今日话题《占道暴走团不应为被撞负全责》？	qa_others
养小鹿犬或者吉娃娃是什么样的体验呢？	qa_others
新生儿由母乳和配方奶喂养，需要额外补充DHA吗？如需要，是鱼油好还是藻油好？哪个牌子的安全些？	qa_others
有什么样特征或特质的男生你不会和他谈恋爱？（前提是你喜欢他）？	qa_others
如何评价“萌码”这个网站？	qa_others
如何看待武汉的大暴雨造成如此后果？	qa_others
如何接吻男票会硬？	qa_others
为什么说长征是「伟大的」？	qa_others
剩下59天高考如何提高数学？	qa_others
有哪些10元以下的实用文艺小物件？	qa_others
金庸小说里最萌的人物是谁？	qa_others
考研结束，你有什么想说的？	qa_others
如何理解马尔克斯《苦妓回忆录》？	qa_others
留学生代购风险那么大为什么不去打工？	qa_others
如何看待【饿了么社论】:但愿你心有所持，温和坚定？	qa_others
国外色情行业管理体系和产业链是怎样的？	qa_others
你最后悔买的小米产品是哪一个？	qa_others
现实中车真的可以爬上45°坡吗？	qa_others
如何评价老罗的锤子科技对OpenSSL基金会捐款100万元这件事？	qa_others
中国女生是否不如日本、韩国女生优秀？	qa_others
你们见过最抠门的老板什么样子？	qa_others
如何评价10月日剧Chef～三星校餐？	qa_others
如何评价语c？blc真的会对青少年成长产生负面影响吗？	qa_others
大二迷茫学生对考研和人生的困惑?	qa_others
高考复读会遇到哪些困难？我的复读理由充不充足？	qa_others
闭关锁国的日本，为什么会一眨眼，成了对外侵伐的罪恶之国？	qa_others
你最性感而又不失保守的照片是哪张？	qa_others
二本学校就不是学校了吗？	qa_others
韩国化妆品到底怎么样呢？	qa_others
男同性恋真的分「攻」、「受」吗？	qa_others
大学生最可行的自费摩托车旅行方案是？	qa_others
合肥有哪些不错的IT公司？	qa_others
电子商务的现状?	qa_others
有哪些好看的明清小说？	qa_others
做爱时女人在想什么？	qa_others
中国股市这一轮暴跌导致了中产阶级和平民怎么样的损失？	qa_others
技术移民加拿大有什么条件？	qa_others
《南方周末》这四个字对你意味着什么？	qa_others
白银连环杀人案犯高承勇是个什么样的人？怎样分析他的心理？	qa_others
有哪些适合家长学习的儿童教育书籍？	qa_others
中国有哪些小而美的城市？	qa_others
古生物学家在缅甸琥珀市场发现了含有完整恐龙尾巴的琥珀有何重大意义？	qa_others
人权重要还是通过打土豪分田地重要？	qa_others
杂志谈到越南女性地位低，儿子吃饭后母亲才能吃是真的吗？	qa_others
我们新开了家早教中心，可是一直招不到合适的老师，怎么办？	qa_others
你听过的三观极正的一句话是？	qa_others
说话语速快的人是否更聪明？	qa_others
自己当老板真的像看起来那么美好么？	qa_others
哪些纪录片可以称为「神作」？	qa_others
染发烫发真的会导致白血病吗？	qa_others
一个人的人心究竟能有多坏？	qa_others
男朋友总是说忙，是不是不爱我了？	qa_others
视力正常的人如何提高视力？	qa_others
问答社区用户如何参观问答社区办公室，是否有开放日之类的活动？	qa_others
如何看待Selina（任家萱）离婚？	qa_others
怎么看待网上爆出的南京农业大学动物实验事件？	qa_others
为什么会有女人只因为怀有两个月的身孕就可以一而再再而三的原谅男人出轨？	qa_others
老干妈、小肥羊火锅底料这些东西能放旅行箱里带过海关吗？	qa_others
准备复读，暑假应该怎么复习？	qa_others
有没有人跟我一样，心里忘不掉前任的？不管换了几个对象，那个人就是释怀不了？请问应该怎么解决?	qa_others
宜家哪些产品不值得买？	qa_others
为什么朝鲜能维持统治这么久？	qa_others
你认为《银魂》里励志或感人的对白是哪段？	qa_others
「强行污」是一种怎样的体验？	qa_others
请问，我的婚姻很差么？老公条件和感情也很差么？	qa_others
请问名字三十四划大都活不过六十岁这种说法可靠吗？有依据吗？	qa_others
被妈妈打屁股是一种怎样的体验？	qa_others
哪种锻炼方式最能让程序员远离亚健康？	qa_others
颧骨内推是怎样一种手术？	qa_others
彭德怀和麦克阿瑟，谁的军事统帅水平更高？	qa_others
交往四年的男朋友，经常莫名其妙地打我，怎么办？	qa_others
丈母娘很作，常在老婆面前说我不好，影响夫妻感情，怎么处理？	qa_others
被篡改的历史教科书在日本的普及率大概是多少？	qa_others
如何看待党报的评论「中国已不可能落入拉美式『中等收入陷阱』」？	qa_others
肾结石有什么症状？	qa_others
为什么我无法分辨男生是否帅？	qa_others
如何评价papi酱的长相？古典美女貌似不是，办公室女郎貌似不是	qa_others
